PokerStars Hand #212112576883:  Hold'em No Limit ($0.01/$0.02 USD) - 2020/04/16 13:44:16 ET
Table 'Aksnes II' 9-max Seat #6 is the button
Seat 1: Parker09SA ($3.58 in chips)
Seat 2: pokerHero1 ($2.28 in chips)
Seat 3: fifita78 ($1.35 in chips)
Seat 4: FOFLOP ($2.61 in chips)
Seat 6: Undispute477 ($0.78 in chips)
Seat 7: Snakes83 ($2.29 in chips)
Seat 8: BRUNOFUENTES27 ($1.33 in chips)
Seat 9: Finalflash007 ($2.23 in chips)
Snakes83: posts small blind $0.01
BRUNOFUENTES27: posts big blind $0.02
*** HOLE CARDS ***
Dealt to pokerHero1 [Kc Ah]
Finalflash007: folds
JudasBenHur1 leaves the table
Parker09SA: folds
pokerHero1: raises $0.06 to $0.08
fifita78: folds
FOFLOP: calls $0.08
Undispute477: folds
Snakes83: calls $0.07
BRUNOFUENTES27: folds
*** FLOP *** [6d Kd 7c]
Snakes83: checks
pokerHero1: bets $0.22
FOFLOP: folds
Snakes83: folds
Uncalled bet ($0.22) returned to pokerHero1
pokerHero1 collected $0.25 from pot
pokerHero1: doesn't show hand
*** SUMMARY ***
Total pot $0.26 | Rake $0.01
Board [6d Kd 7c]
Seat 1: Parker09SA folded before Flop (didn't bet)
Seat 2: pokerHero1 collected ($0.25)
Seat 3: fifita78 folded before Flop (didn't bet)
Seat 4: FOFLOP folded on the Flop
Seat 6: Undispute477 (button) folded before Flop (didn't bet)
Seat 7: Snakes83 (small blind) folded on the Flop
Seat 8: BRUNOFUENTES27 (big blind) folded before Flop
Seat 9: Finalflash007 folded before Flop (didn't bet)



PokerStars Hand #212112629226:  Hold'em No Limit ($0.01/$0.02 USD) - 2020/04/16 13:45:06 ET
Table 'Aksnes II' 9-max Seat #7 is the button
Seat 1: Parker09SA ($3.58 in chips)
Seat 2: pokerHero1 ($2.45 in chips)
Seat 3: fifita78 ($1.35 in chips)
Seat 4: FOFLOP ($2.53 in chips)
Seat 6: Undispute477 ($0.78 in chips)
Seat 7: Snakes83 ($2.21 in chips)
Seat 8: BRUNOFUENTES27 ($1.31 in chips)
Seat 9: Finalflash007 ($2.23 in chips)
BRUNOFUENTES27: posts small blind $0.01
Finalflash007: posts big blind $0.02
*** HOLE CARDS ***
Dealt to pokerHero1 [Qc 7s]
Parker09SA: raises $0.04 to $0.06
pokerHero1: folds
fifita78: folds
FOFLOP: calls $0.06
Undispute477: folds
Snakes83: folds
BRUNOFUENTES27: calls $0.05
Finalflash007: folds
*** FLOP *** [9s Qd 6d]
grindhauz joins the table at seat #5
BRUNOFUENTES27: checks
Parker09SA: checks
FOFLOP: bets $0.06
BRUNOFUENTES27: raises $0.06 to $0.12
Parker09SA: folds
FOFLOP: calls $0.06
*** TURN *** [9s Qd 6d] [9d]
BRUNOFUENTES27: checks
FOFLOP: checks
*** RIVER *** [9s Qd 6d 9d] [Ac]
BRUNOFUENTES27: checks
FOFLOP: checks
*** SHOW DOWN ***
BRUNOFUENTES27: shows [Jh 8d] (a pair of Nines)
FOFLOP: shows [6s Ks] (two pair, Nines and Sixes)
FOFLOP collected $0.42 from pot
*** SUMMARY ***
Total pot $0.44 | Rake $0.02
Board [9s Qd 6d 9d Ac]
Seat 1: Parker09SA folded on the Flop
Seat 2: pokerHero1 folded before Flop (didn't bet)
Seat 3: fifita78 folded before Flop (didn't bet)
Seat 4: FOFLOP showed [6s Ks] and won ($0.42) with two pair, Nines and Sixes
Seat 6: Undispute477 folded before Flop (didn't bet)
Seat 7: Snakes83 (button) folded before Flop (didn't bet)
Seat 8: BRUNOFUENTES27 (small blind) showed [Jh 8d] and lost with a pair of Nines
Seat 9: Finalflash007 (big blind) folded before Flop



PokerStars Hand #212112705845:  Hold'em No Limit ($0.01/$0.02 USD) - 2020/04/16 13:46:19 ET
Table 'Aksnes II' 9-max Seat #8 is the button
Seat 1: Parker09SA ($3.52 in chips)
Seat 2: pokerHero1 ($2.45 in chips)
Seat 3: fifita78 ($1.35 in chips)
Seat 4: FOFLOP ($2.77 in chips)
Seat 5: grindhauz ($0.80 in chips)
Seat 6: Undispute477 ($0.78 in chips)
Seat 7: Snakes83 ($2.21 in chips)
Seat 8: BRUNOFUENTES27 ($1.13 in chips)
Seat 9: Finalflash007 ($2.21 in chips)
Finalflash007: posts small blind $0.01
Parker09SA: posts big blind $0.02
grindhauz: posts big blind $0.02
*** HOLE CARDS ***
Dealt to pokerHero1 [Qh 7c]
pokerHero1: folds
fifita78: folds
FOFLOP: folds
grindhauz: checks
Undispute477: folds
Snakes83: folds
BRUNOFUENTES27: calls $0.02
Finalflash007: folds
Parker09SA: checks
*** FLOP *** [4c Ah 5c]
Parker09SA: checks
grindhauz: checks
BRUNOFUENTES27: checks
*** TURN *** [4c Ah 5c] [Tc]
Parker09SA: checks
grindhauz: checks
BRUNOFUENTES27: checks
*** RIVER *** [4c Ah 5c Tc] [Th]
Parker09SA: checks
grindhauz: checks
BRUNOFUENTES27: checks
*** SHOW DOWN ***
Parker09SA: shows [9d 6c] (a pair of Tens)
grindhauz: shows [9h 8c] (a pair of Tens - Ace+Nine+Eight kicker)
BRUNOFUENTES27: shows [8s Js] (a pair of Tens - Ace+Jack kicker)
BRUNOFUENTES27 collected $0.07 from pot
*** SUMMARY ***
Total pot $0.07 | Rake $0
Board [4c Ah 5c Tc Th]
Seat 1: Parker09SA (big blind) showed [9d 6c] and lost with a pair of Tens
Seat 2: pokerHero1 folded before Flop (didn't bet)
Seat 3: fifita78 folded before Flop (didn't bet)
Seat 4: FOFLOP folded before Flop (didn't bet)
Seat 5: grindhauz showed [9h 8c] and lost with a pair of Tens
Seat 6: Undispute477 folded before Flop (didn't bet)
Seat 7: Snakes83 folded before Flop (didn't bet)
Seat 8: BRUNOFUENTES27 (button) showed [8s Js] and won ($0.07) with a pair of Tens
Seat 9: Finalflash007 (small blind) folded before Flop



PokerStars Hand #212112755036:  Hold'em No Limit ($0.01/$0.02 USD) - 2020/04/16 13:47:01 ET
Table 'Aksnes II' 9-max Seat #9 is the button
Seat 1: Parker09SA ($3.50 in chips)
Seat 2: pokerHero1 ($2.45 in chips)
Seat 3: fifita78 ($1.35 in chips)
Seat 4: FOFLOP ($2.77 in chips)
Seat 5: grindhauz ($0.78 in chips)
Seat 6: Undispute477 ($0.78 in chips)
Seat 7: Snakes83 ($2.21 in chips)
Seat 8: BRUNOFUENTES27 ($1.18 in chips)
Seat 9: Finalflash007 ($2.20 in chips)
Parker09SA: posts small blind $0.01
pokerHero1: posts big blind $0.02
*** HOLE CARDS ***
Dealt to pokerHero1 [6h 3c]
fifita78: folds
FOFLOP: folds
grindhauz: calls $0.02
Undispute477: folds
Snakes83: folds
BRUNOFUENTES27: calls $0.02
Finalflash007: raises $0.05 to $0.07
Parker09SA: calls $0.06
pokerHero1: folds
grindhauz: calls $0.05
BRUNOFUENTES27: calls $0.05
*** FLOP *** [2s Td 4h]
Parker09SA: checks
grindhauz: checks
BRUNOFUENTES27: checks
Finalflash007: bets $0.19
Parker09SA: folds
grindhauz: folds
BRUNOFUENTES27: calls $0.19
*** TURN *** [2s Td 4h] [9c]
BRUNOFUENTES27: bets $0.92 and is all-in
Finalflash007: folds
Uncalled bet ($0.92) returned to BRUNOFUENTES27
BRUNOFUENTES27 collected $0.66 from pot
BRUNOFUENTES27: doesn't show hand
*** SUMMARY ***
Total pot $0.68 | Rake $0.02
Board [2s Td 4h 9c]
Seat 1: Parker09SA (small blind) folded on the Flop
Seat 2: pokerHero1 (big blind) folded before Flop
Seat 3: fifita78 folded before Flop (didn't bet)
Seat 4: FOFLOP folded before Flop (didn't bet)
Seat 5: grindhauz folded on the Flop
Seat 6: Undispute477 folded before Flop (didn't bet)
Seat 7: Snakes83 folded before Flop (didn't bet)
Seat 8: BRUNOFUENTES27 collected ($0.66)
Seat 9: Finalflash007 (button) folded on the Turn



PokerStars Hand #212112822539:  Hold'em No Limit ($0.01/$0.02 USD) - 2020/04/16 13:48:07 ET
Table 'Aksnes II' 9-max Seat #1 is the button
Seat 1: Parker09SA ($3.43 in chips)
Seat 2: pokerHero1 ($2.43 in chips)
Seat 3: fifita78 ($1.35 in chips)
Seat 4: FOFLOP ($2.77 in chips)
Seat 5: grindhauz ($0.71 in chips)
Seat 6: Undispute477 ($0.78 in chips)
Seat 7: Snakes83 ($2.21 in chips)
Seat 8: BRUNOFUENTES27 ($2 in chips)
Seat 9: Finalflash007 ($2 in chips)
pokerHero1: posts small blind $0.01
fifita78: posts big blind $0.02
*** HOLE CARDS ***
Dealt to pokerHero1 [2d Td]
FOFLOP: calls $0.02
grindhauz: calls $0.02
Undispute477: folds
Snakes83: folds
BRUNOFUENTES27: calls $0.02
Finalflash007: folds
Parker09SA: calls $0.02
pokerHero1: calls $0.01
fifita78: checks
*** FLOP *** [8c 3c Jh]
pokerHero1: checks
fifita78: checks
FOFLOP: bets $0.04
grindhauz: folds
BRUNOFUENTES27: folds
Parker09SA: calls $0.04
pokerHero1: folds
fifita78: calls $0.04
*** TURN *** [8c 3c Jh] [9c]
fifita78: checks
FOFLOP: checks
Parker09SA: checks
*** RIVER *** [8c 3c Jh 9c] [6c]
fifita78: checks
FOFLOP: bets $0.08
Parker09SA: folds
fifita78: folds
Uncalled bet ($0.08) returned to FOFLOP
FOFLOP collected $0.23 from pot
*** SUMMARY ***
Total pot $0.24 | Rake $0.01
Board [8c 3c Jh 9c 6c]
Seat 1: Parker09SA (button) folded on the River
Seat 2: pokerHero1 (small blind) folded on the Flop
Seat 3: fifita78 (big blind) folded on the River
Seat 4: FOFLOP collected ($0.23)
Seat 5: grindhauz folded on the Flop
Seat 6: Undispute477 folded before Flop (didn't bet)
Seat 7: Snakes83 folded before Flop (didn't bet)
Seat 8: BRUNOFUENTES27 folded on the Flop
Seat 9: Finalflash007 folded before Flop (didn't bet)



PokerStars Hand #212112918122:  Hold'em No Limit ($0.01/$0.02 USD) - 2020/04/16 13:49:40 ET
Table 'Aksnes II' 9-max Seat #2 is the button
Seat 1: Parker09SA ($3.37 in chips)
Seat 2: pokerHero1 ($2.41 in chips)
Seat 3: fifita78 ($1.29 in chips)
Seat 5: grindhauz ($0.69 in chips)
Seat 6: Undispute477 ($0.78 in chips)
Seat 7: Snakes83 ($2.21 in chips)
Seat 8: BRUNOFUENTES27 ($1.98 in chips)
Seat 9: Finalflash007 ($2 in chips)
fifita78: posts small blind $0.01
FOFLOP: is sitting out
grindhauz: posts big blind $0.02
*** HOLE CARDS ***
Dealt to pokerHero1 [6c 7h]
Undispute477: folds
Snakes83: folds
BRUNOFUENTES27: calls $0.02
Finalflash007: folds
Parker09SA: raises $0.08 to $0.10
pokerHero1: folds
fifita78: folds
grindhauz: folds
BRUNOFUENTES27: calls $0.08
*** FLOP *** [Ac 4d 5c]
BRUNOFUENTES27: checks
Parker09SA: bets $0.12
BRUNOFUENTES27: calls $0.12
*** TURN *** [Ac 4d 5c] [4s]
BRUNOFUENTES27: bets $0.45
Parker09SA: calls $0.45
*** RIVER *** [Ac 4d 5c 4s] [Jh]
FOFLOP leaves the table
BRUNOFUENTES27: checks
Parker09SA: checks
*** SHOW DOWN ***
BRUNOFUENTES27: shows [5d 7d] (two pair, Fives and Fours)
Parker09SA: mucks hand
BRUNOFUENTES27 collected $1.32 from pot
*** SUMMARY ***
Total pot $1.37 | Rake $0.05
Board [Ac 4d 5c 4s Jh]
Seat 1: Parker09SA mucked [Qc Kc]
Seat 2: pokerHero1 (button) folded before Flop (didn't bet)
Seat 3: fifita78 (small blind) folded before Flop
Seat 5: grindhauz (big blind) folded before Flop
Seat 6: Undispute477 folded before Flop (didn't bet)
Seat 7: Snakes83 folded before Flop (didn't bet)
Seat 8: BRUNOFUENTES27 showed [5d 7d] and won ($1.32) with two pair, Fives and Fours
Seat 9: Finalflash007 folded before Flop (didn't bet)



PokerStars Hand #212112975307:  Hold'em No Limit ($0.01/$0.02 USD) - 2020/04/16 13:50:34 ET
Table 'Aksnes II' 9-max Seat #3 is the button
Seat 1: Parker09SA ($2.70 in chips)
Seat 2: pokerHero1 ($2.41 in chips)
Seat 3: fifita78 ($1.28 in chips)
Seat 5: grindhauz ($0.67 in chips)
Seat 6: Undispute477 ($0.78 in chips)
Seat 7: Snakes83 ($2.21 in chips)
Seat 8: BRUNOFUENTES27 ($2.63 in chips)
Seat 9: Finalflash007 ($2 in chips)
grindhauz: posts small blind $0.01
Undispute477: posts big blind $0.02
*** HOLE CARDS ***
Dealt to pokerHero1 [6h Js]
Snakes83: folds
Abrams195 joins the table at seat #4
BRUNOFUENTES27 has timed out
BRUNOFUENTES27: folds
Finalflash007: folds
Snakes83 leaves the table
Parker09SA: folds
BRUNOFUENTES27 is disconnected
pokerHero1: raises $0.04 to $0.06
fifita78: calls $0.06
grindhauz: raises $0.61 to $0.67 and is all-in
Undispute477: folds
Jerry194208 joins the table at seat #7
pokerHero1: folds
fifita78: folds
Uncalled bet ($0.61) returned to grindhauz
grindhauz collected $0.20 from pot
grindhauz: doesn't show hand
*** SUMMARY ***
Total pot $0.20 | Rake $0
Seat 1: Parker09SA folded before Flop (didn't bet)
Seat 2: pokerHero1 folded before Flop
Seat 3: fifita78 (button) folded before Flop
Seat 5: grindhauz (small blind) collected ($0.20)
Seat 6: Undispute477 (big blind) folded before Flop
Seat 7: Snakes83 folded before Flop (didn't bet)
Seat 8: BRUNOFUENTES27 folded before Flop (didn't bet)
Seat 9: Finalflash007 folded before Flop (didn't bet)



PokerStars Hand #212113029927:  Hold'em No Limit ($0.01/$0.02 USD) - 2020/04/16 13:51:27 ET
Table 'Aksnes II' 9-max Seat #5 is the button
Seat 1: Parker09SA ($2.70 in chips)
Seat 2: pokerHero1 ($2.35 in chips)
Seat 3: fifita78 ($1.22 in chips)
Seat 5: grindhauz ($0.81 in chips)
Seat 6: Undispute477 ($0.76 in chips)
Seat 7: Jerry194208 ($2 in chips)
Seat 8: BRUNOFUENTES27 ($2.63 in chips)
Seat 9: Finalflash007 ($2 in chips)
Undispute477: posts small blind $0.01
Jerry194208: posts big blind $0.02
*** HOLE CARDS ***
Dealt to pokerHero1 [2s 6h]
BRUNOFUENTES27: folds
Finalflash007: raises $0.05 to $0.07
Parker09SA: folds
pokerHero1: folds
fifita78: folds
grindhauz: folds
Undispute477: folds
Jerry194208: calls $0.05
*** FLOP *** [3h As Kh]
Jerry194208: bets $0.02
Finalflash007: raises $0.12 to $0.14
Abrams195 leaves the table
Jerry194208: calls $0.12
*** TURN *** [3h As Kh] [Kc]
Jerry194208: bets $0.02
Finalflash007: calls $0.02
*** RIVER *** [3h As Kh Kc] [6d]
Jerry194208: bets $0.02
Finalflash007: calls $0.02
*** SHOW DOWN ***
Jerry194208: shows [8h Ad] (two pair, Aces and Kings)
Finalflash007: shows [Ah Qh] (two pair, Aces and Kings - Queen kicker)
Finalflash007 collected $0.49 from pot
*** SUMMARY ***
Total pot $0.51 | Rake $0.02
Board [3h As Kh Kc 6d]
Seat 1: Parker09SA folded before Flop (didn't bet)
Seat 2: pokerHero1 folded before Flop (didn't bet)
Seat 3: fifita78 folded before Flop (didn't bet)
Seat 5: grindhauz (button) folded before Flop (didn't bet)
Seat 6: Undispute477 (small blind) folded before Flop
Seat 7: Jerry194208 (big blind) showed [8h Ad] and lost with two pair, Aces and Kings
Seat 8: BRUNOFUENTES27 folded before Flop (didn't bet)
Seat 9: Finalflash007 showed [Ah Qh] and won ($0.49) with two pair, Aces and Kings



PokerStars Hand #212113079175:  Hold'em No Limit ($0.01/$0.02 USD) - 2020/04/16 13:52:15 ET
Table 'Aksnes II' 9-max Seat #6 is the button
Seat 1: Parker09SA ($2.70 in chips)
Seat 2: pokerHero1 ($2.35 in chips)
Seat 3: fifita78 ($1.22 in chips)
Seat 5: grindhauz ($0.81 in chips)
Seat 6: Undispute477 ($0.75 in chips)
Seat 7: Jerry194208 ($1.75 in chips)
Seat 8: BRUNOFUENTES27 ($2.63 in chips)
Seat 9: Finalflash007 ($2.24 in chips)
Jerry194208: posts small blind $0.01
Buscapina277 joins the table at seat #4
BRUNOFUENTES27: posts big blind $0.02
*** HOLE CARDS ***
Dealt to pokerHero1 [9s 5s]
Finalflash007: folds
Parker09SA: folds
pokerHero1: folds
fifita78: folds
grindhauz: folds
Undispute477 has timed out
Undispute477: folds
Jerry194208: calls $0.01
BRUNOFUENTES27: checks
*** FLOP *** [Qh Kd 3d]
Jerry194208: checks
BRUNOFUENTES27: checks
*** TURN *** [Qh Kd 3d] [3h]
Jerry194208: checks
BRUNOFUENTES27: checks
*** RIVER *** [Qh Kd 3d 3h] [Qd]
Jerry194208: checks
BRUNOFUENTES27: bets $0.02
Jerry194208: folds
Uncalled bet ($0.02) returned to BRUNOFUENTES27
BRUNOFUENTES27 collected $0.04 from pot
BRUNOFUENTES27: doesn't show hand
*** SUMMARY ***
Total pot $0.04 | Rake $0
Board [Qh Kd 3d 3h Qd]
Seat 1: Parker09SA folded before Flop (didn't bet)
Seat 2: pokerHero1 folded before Flop (didn't bet)
Seat 3: fifita78 folded before Flop (didn't bet)
Seat 5: grindhauz folded before Flop (didn't bet)
Seat 6: Undispute477 (button) folded before Flop (didn't bet)
Seat 7: Jerry194208 (small blind) folded on the River
Seat 8: BRUNOFUENTES27 (big blind) collected ($0.04)
Seat 9: Finalflash007 folded before Flop (didn't bet)



PokerStars Hand #212113150529:  Hold'em No Limit ($0.01/$0.02 USD) - 2020/04/16 13:53:18 ET
Table 'Aksnes II' 9-max Seat #7 is the button
Seat 1: Parker09SA ($2.70 in chips)
Seat 2: pokerHero1 ($2.35 in chips)
Seat 3: fifita78 ($1.22 in chips)
Seat 5: grindhauz ($0.81 in chips)
Seat 6: Undispute477 ($0.75 in chips)
Seat 7: Jerry194208 ($1.73 in chips)
Seat 8: BRUNOFUENTES27 ($2.65 in chips)
Seat 9: Finalflash007 ($2.24 in chips)
BRUNOFUENTES27: posts small blind $0.01
Finalflash007: posts big blind $0.02
Buscapina277: sits out
*** HOLE CARDS ***
Dealt to pokerHero1 [Qh 6s]
Parker09SA: folds
pokerHero1: folds
fifita78: calls $0.02
grindhauz: raises $0.02 to $0.04
Undispute477: raises $0.12 to $0.16
Jerry194208: folds
BRUNOFUENTES27: folds
Finalflash007: folds
fifita78: folds
grindhauz: calls $0.12
*** FLOP *** [8d 3c 7d]
grindhauz: bets $0.10
Undispute477: raises $0.49 to $0.59 and is all-in
grindhauz: calls $0.49
*** TURN *** [8d 3c 7d] [2d]
*** RIVER *** [8d 3c 7d 2d] [Js]
*** SHOW DOWN ***
grindhauz: shows [As 8s] (a pair of Eights)
Undispute477: shows [Jh Ac] (a pair of Jacks)
Undispute477 collected $1.50 from pot
*** SUMMARY ***
Total pot $1.55 | Rake $0.05
Board [8d 3c 7d 2d Js]
Seat 1: Parker09SA folded before Flop (didn't bet)
Seat 2: pokerHero1 folded before Flop (didn't bet)
Seat 3: fifita78 folded before Flop
Seat 5: grindhauz showed [As 8s] and lost with a pair of Eights
Seat 6: Undispute477 showed [Jh Ac] and won ($1.50) with a pair of Jacks
Seat 7: Jerry194208 (button) folded before Flop (didn't bet)
Seat 8: BRUNOFUENTES27 (small blind) folded before Flop
Seat 9: Finalflash007 (big blind) folded before Flop



