PokerStars Hand #212511343387:  Hold'em No Limit ($0.01/$0.02 USD) - 2020/04/22 12:43:52 ET
Table 'Jena II' 9-max Seat #8 is the button
Seat 2: pokerHero1 ($2 in chips)
Seat 3: Tuz_i_Tuz ($2.27 in chips)
Seat 4: stavochka008 ($0.56 in chips)
Seat 5: nightwolfpro ($2.99 in chips)
Seat 6: anghelstefanesc ($1.60 in chips)
Seat 8: DrowsyDays ($4.24 in chips)
Seat 9: vigi1ante ($1.89 in chips)
vigi1ante: posts small blind $0.01
pokerHero1: posts big blind $0.02
anghelstefanesc: posts big blind $0.02
*** HOLE CARDS ***
Dealt to pokerHero1 [5c Qh]
Tuz_i_Tuz: raises $0.08 to $0.10
stavochka008: folds
nightwolfpro: folds
anghelstefanesc: folds
DrowsyDays: folds
vigi1ante: folds
pokerHero1: folds
Uncalled bet ($0.08) returned to Tuz_i_Tuz
Tuz_i_Tuz collected $0.07 from pot
Tuz_i_Tuz: doesn't show hand
*** SUMMARY ***
Total pot $0.07 | Rake $0
Seat 2: pokerHero1 (big blind) folded before Flop
Seat 3: Tuz_i_Tuz collected ($0.07)
Seat 4: stavochka008 folded before Flop (didn't bet)
Seat 5: nightwolfpro folded before Flop (didn't bet)
Seat 6: anghelstefanesc folded before Flop (didn't bet)
Seat 8: DrowsyDays (button) folded before Flop (didn't bet)
Seat 9: vigi1ante (small blind) folded before Flop



PokerStars Hand #212511363286:  Hold'em No Limit ($0.01/$0.02 USD) - 2020/04/22 12:44:14 ET
Table 'Jena II' 9-max Seat #9 is the button
Seat 2: pokerHero1 ($1.98 in chips)
Seat 3: Tuz_i_Tuz ($2.32 in chips)
Seat 4: stavochka008 ($0.56 in chips)
Seat 5: nightwolfpro ($2.99 in chips)
Seat 6: anghelstefanesc ($1.58 in chips)
Seat 8: DrowsyDays ($4.24 in chips)
Seat 9: vigi1ante ($1.88 in chips)
pokerHero1: posts small blind $0.01
Tuz_i_Tuz: posts big blind $0.02
*** HOLE CARDS ***
Dealt to pokerHero1 [Js Kh]
stavochka008: folds
nightwolfpro: folds
anghelstefanesc: folds
DrowsyDays: folds
vigi1ante: folds
pokerHero1: raises $0.04 to $0.06
Tuz_i_Tuz: folds
Uncalled bet ($0.04) returned to pokerHero1
pokerHero1 collected $0.04 from pot
pokerHero1: doesn't show hand
*** SUMMARY ***
Total pot $0.04 | Rake $0
Seat 2: pokerHero1 (small blind) collected ($0.04)
Seat 3: Tuz_i_Tuz (big blind) folded before Flop
Seat 4: stavochka008 folded before Flop (didn't bet)
Seat 5: nightwolfpro folded before Flop (didn't bet)
Seat 6: anghelstefanesc folded before Flop (didn't bet)
Seat 8: DrowsyDays folded before Flop (didn't bet)
Seat 9: vigi1ante (button) folded before Flop (didn't bet)



PokerStars Hand #212511398322:  Hold'em No Limit ($0.01/$0.02 USD) - 2020/04/22 12:44:53 ET
Table 'Jena II' 9-max Seat #2 is the button
Seat 2: pokerHero1 ($2 in chips)
Seat 3: Tuz_i_Tuz ($2.30 in chips)
Seat 4: stavochka008 ($0.56 in chips)
Seat 5: nightwolfpro ($2.99 in chips)
Seat 6: anghelstefanesc ($1.58 in chips)
Seat 8: DrowsyDays ($4.24 in chips)
Seat 9: vigi1ante ($1.88 in chips)
Tuz_i_Tuz: posts small blind $0.01
stavochka008: posts big blind $0.02
xTiMMeL: sits out
*** HOLE CARDS ***
Dealt to pokerHero1 [2s 8d]
nightwolfpro: folds
anghelstefanesc: folds
DrowsyDays: raises $0.04 to $0.06
vigi1ante: folds
pokerHero1: folds
Tuz_i_Tuz: folds
stavochka008: calls $0.04
*** FLOP *** [Ac 5d Th]
stavochka008: bets $0.08
DrowsyDays: folds
Uncalled bet ($0.08) returned to stavochka008
stavochka008 collected $0.13 from pot
stavochka008: doesn't show hand
*** SUMMARY ***
Total pot $0.13 | Rake $0
Board [Ac 5d Th]
Seat 2: pokerHero1 (button) folded before Flop (didn't bet)
Seat 3: Tuz_i_Tuz (small blind) folded before Flop
Seat 4: stavochka008 (big blind) collected ($0.13)
Seat 5: nightwolfpro folded before Flop (didn't bet)
Seat 6: anghelstefanesc folded before Flop (didn't bet)
Seat 8: DrowsyDays folded on the Flop
Seat 9: vigi1ante folded before Flop (didn't bet)



PokerStars Hand #212511423127:  Hold'em No Limit ($0.01/$0.02 USD) - 2020/04/22 12:45:19 ET
Table 'Jena II' 9-max Seat #3 is the button
Seat 1: xTiMMeL ($1.97 in chips)
Seat 2: pokerHero1 ($2 in chips)
Seat 3: Tuz_i_Tuz ($2.29 in chips)
Seat 4: stavochka008 ($0.63 in chips)
Seat 5: nightwolfpro ($2.99 in chips)
Seat 6: anghelstefanesc ($1.58 in chips)
Seat 8: DrowsyDays ($4.18 in chips)
Seat 9: vigi1ante ($1.88 in chips)
stavochka008: posts small blind $0.01
nightwolfpro: posts big blind $0.02
xTiMMeL: posts small & big blinds $0.03
*** HOLE CARDS ***
Dealt to pokerHero1 [7s Tc]
anghelstefanesc: folds
DrowsyDays: folds
vigi1ante: folds
xTiMMeL: checks
pokerHero1: folds
Tuz_i_Tuz: calls $0.02
stavochka008: calls $0.01
nightwolfpro: checks
*** FLOP *** [2c 7c Kc]
stavochka008: checks
nightwolfpro: checks
xTiMMeL is disconnected
xTiMMeL is connected
xTiMMeL: checks
Tuz_i_Tuz: bets $0.06
stavochka008: folds
nightwolfpro: folds
xTiMMeL: folds
Uncalled bet ($0.06) returned to Tuz_i_Tuz
Tuz_i_Tuz collected $0.09 from pot
Tuz_i_Tuz: doesn't show hand
*** SUMMARY ***
Total pot $0.09 | Rake $0
Board [2c 7c Kc]
Seat 1: xTiMMeL folded on the Flop (didn't bet)
Seat 2: pokerHero1 folded before Flop (didn't bet)
Seat 3: Tuz_i_Tuz (button) collected ($0.09)
Seat 4: stavochka008 (small blind) folded on the Flop
Seat 5: nightwolfpro (big blind) folded on the Flop
Seat 6: anghelstefanesc folded before Flop (didn't bet)
Seat 8: DrowsyDays folded before Flop (didn't bet)
Seat 9: vigi1ante folded before Flop (didn't bet)



PokerStars Hand #212511490244:  Hold'em No Limit ($0.01/$0.02 USD) - 2020/04/22 12:46:33 ET
Table 'Jena II' 9-max Seat #4 is the button
Seat 1: xTiMMeL ($1.94 in chips)
Seat 2: pokerHero1 ($2 in chips)
Seat 3: Tuz_i_Tuz ($2.36 in chips)
Seat 4: stavochka008 ($0.61 in chips)
Seat 5: nightwolfpro ($2.97 in chips)
Seat 6: anghelstefanesc ($1.58 in chips)
Seat 8: DrowsyDays ($4.18 in chips)
Seat 9: vigi1ante ($1.88 in chips)
nightwolfpro: posts small blind $0.01
anghelstefanesc: posts big blind $0.02
*** HOLE CARDS ***
Dealt to pokerHero1 [Qs 2s]
DrowsyDays: folds
vigi1ante: folds
xTiMMeL: calls $0.02
pokerHero1: folds
Tuz_i_Tuz: folds
stavochka008: folds
nightwolfpro: folds
anghelstefanesc: checks
*** FLOP *** [Qh 9d 5c]
anghelstefanesc: checks
xTiMMeL: bets $0.04
anghelstefanesc: folds
Uncalled bet ($0.04) returned to xTiMMeL
xTiMMeL collected $0.05 from pot
xTiMMeL: doesn't show hand
*** SUMMARY ***
Total pot $0.05 | Rake $0
Board [Qh 9d 5c]
Seat 1: xTiMMeL collected ($0.05)
Seat 2: pokerHero1 folded before Flop (didn't bet)
Seat 3: Tuz_i_Tuz folded before Flop (didn't bet)
Seat 4: stavochka008 (button) folded before Flop (didn't bet)
Seat 5: nightwolfpro (small blind) folded before Flop
Seat 6: anghelstefanesc (big blind) folded on the Flop
Seat 8: DrowsyDays folded before Flop (didn't bet)
Seat 9: vigi1ante folded before Flop (didn't bet)



PokerStars Hand #212511527123:  Hold'em No Limit ($0.01/$0.02 USD) - 2020/04/22 12:47:13 ET
Table 'Jena II' 9-max Seat #5 is the button
Seat 1: xTiMMeL ($1.97 in chips)
Seat 2: pokerHero1 ($2 in chips)
Seat 3: Tuz_i_Tuz ($2.36 in chips)
Seat 4: stavochka008 ($0.61 in chips)
Seat 5: nightwolfpro ($2.96 in chips)
Seat 6: anghelstefanesc ($1.56 in chips)
Seat 8: DrowsyDays ($4.18 in chips)
Seat 9: vigi1ante ($1.88 in chips)
anghelstefanesc: posts small blind $0.01
DrowsyDays: posts big blind $0.02
*** HOLE CARDS ***
Dealt to pokerHero1 [Js 8s]
vigi1ante: folds
vigi1ante leaves the table
xTiMMeL: calls $0.02
LipDoom joins the table at seat #9
pokerHero1: folds
Tuz_i_Tuz: raises $0.07 to $0.09
stavochka008: folds
nightwolfpro: folds
anghelstefanesc: calls $0.08
DrowsyDays: folds
xTiMMeL: calls $0.07
*** FLOP *** [As Kh 8d]
anghelstefanesc: checks
xTiMMeL: checks
Tuz_i_Tuz: checks
*** TURN *** [As Kh 8d] [5c]
anghelstefanesc: bets $0.06
xTiMMeL: calls $0.06
Tuz_i_Tuz: calls $0.06
*** RIVER *** [As Kh 8d 5c] [7s]
anghelstefanesc: bets $0.02
xTiMMeL: raises $0.24 to $0.26
Tuz_i_Tuz: calls $0.26
anghelstefanesc: folds
*** SHOW DOWN ***
xTiMMeL: shows [Kd Qd] (a pair of Kings)
Tuz_i_Tuz: shows [5h 7h] (two pair, Sevens and Fives)
Tuz_i_Tuz collected $0.97 from pot
*** SUMMARY ***
Total pot $1.01 | Rake $0.04
Board [As Kh 8d 5c 7s]
Seat 1: xTiMMeL showed [Kd Qd] and lost with a pair of Kings
Seat 2: pokerHero1 folded before Flop (didn't bet)
Seat 3: Tuz_i_Tuz showed [5h 7h] and won ($0.97) with two pair, Sevens and Fives
Seat 4: stavochka008 folded before Flop (didn't bet)
Seat 5: nightwolfpro (button) folded before Flop (didn't bet)
Seat 6: anghelstefanesc (small blind) folded on the River
Seat 8: DrowsyDays (big blind) folded before Flop
Seat 9: vigi1ante folded before Flop (didn't bet)



PokerStars Hand #212511629672:  Hold'em No Limit ($0.01/$0.02 USD) - 2020/04/22 12:49:05 ET
Table 'Jena II' 9-max Seat #6 is the button
Seat 1: xTiMMeL ($1.56 in chips)
Seat 2: pokerHero1 ($2 in chips)
Seat 3: Tuz_i_Tuz ($2.92 in chips)
Seat 4: stavochka008 ($0.61 in chips)
Seat 5: nightwolfpro ($2.96 in chips)
Seat 6: anghelstefanesc ($1.39 in chips)
Seat 8: DrowsyDays ($4.16 in chips)
Seat 9: LipDoom ($0.80 in chips)
DrowsyDays: posts small blind $0.01
LipDoom: posts big blind $0.02
*** HOLE CARDS ***
Dealt to pokerHero1 [Kd Qh]
xTiMMeL: folds
pokerHero1: folds
Tuz_i_Tuz: folds
stavochka008: calls $0.02
nightwolfpro: raises $0.08 to $0.10
anghelstefanesc: calls $0.10
DrowsyDays: folds
LipDoom: folds
stavochka008: folds
*** FLOP *** [Ad Jd 7d]
nightwolfpro: bets $0.10
anghelstefanesc: calls $0.10
*** TURN *** [Ad Jd 7d] [Kh]
nightwolfpro: checks
anghelstefanesc: checks
*** RIVER *** [Ad Jd 7d Kh] [3s]
nightwolfpro: bets $0.20
anghelstefanesc: calls $0.20
*** SHOW DOWN ***
nightwolfpro: shows [5c 5d] (a pair of Fives)
anghelstefanesc: shows [8c As] (a pair of Aces)
anghelstefanesc collected $0.82 from pot
*** SUMMARY ***
Total pot $0.85 | Rake $0.03
Board [Ad Jd 7d Kh 3s]
Seat 1: xTiMMeL folded before Flop (didn't bet)
Seat 2: pokerHero1 folded before Flop (didn't bet)
Seat 3: Tuz_i_Tuz folded before Flop (didn't bet)
Seat 4: stavochka008 folded before Flop
Seat 5: nightwolfpro showed [5c 5d] and lost with a pair of Fives
Seat 6: anghelstefanesc (button) showed [8c As] and won ($0.82) with a pair of Aces
Seat 8: DrowsyDays (small blind) folded before Flop
Seat 9: LipDoom (big blind) folded before Flop



PokerStars Hand #212511688412:  Hold'em No Limit ($0.01/$0.02 USD) - 2020/04/22 12:50:09 ET
Table 'Jena II' 9-max Seat #8 is the button
Seat 1: xTiMMeL ($1.56 in chips)
Seat 2: pokerHero1 ($2 in chips)
Seat 3: Tuz_i_Tuz ($2.92 in chips)
Seat 4: stavochka008 ($0.59 in chips)
Seat 5: nightwolfpro ($2.56 in chips)
Seat 6: anghelstefanesc ($1.81 in chips)
Seat 8: DrowsyDays ($4.15 in chips)
Seat 9: LipDoom ($0.78 in chips)
LipDoom: posts small blind $0.01
xTiMMeL: posts big blind $0.02
*** HOLE CARDS ***
Dealt to pokerHero1 [Ts 7d]
pokerHero1: folds
Tuz_i_Tuz: folds
stavochka008: folds
nightwolfpro: folds
anghelstefanesc: folds
DrowsyDays: folds
LipDoom: calls $0.01
xTiMMeL: checks
*** FLOP *** [7h 9h 5s]
LipDoom: checks
xTiMMeL: checks
*** TURN *** [7h 9h 5s] [Qc]
LipDoom: checks
xTiMMeL: bets $0.02
LipDoom: folds
Uncalled bet ($0.02) returned to xTiMMeL
xTiMMeL collected $0.04 from pot
xTiMMeL: doesn't show hand
*** SUMMARY ***
Total pot $0.04 | Rake $0
Board [7h 9h 5s Qc]
Seat 1: xTiMMeL (big blind) collected ($0.04)
Seat 2: pokerHero1 folded before Flop (didn't bet)
Seat 3: Tuz_i_Tuz folded before Flop (didn't bet)
Seat 4: stavochka008 folded before Flop (didn't bet)
Seat 5: nightwolfpro folded before Flop (didn't bet)
Seat 6: anghelstefanesc folded before Flop (didn't bet)
Seat 8: DrowsyDays (button) folded before Flop (didn't bet)
Seat 9: LipDoom (small blind) folded on the Turn



PokerStars Hand #212511721343:  Hold'em No Limit ($0.01/$0.02 USD) - 2020/04/22 12:50:45 ET
Table 'Jena II' 9-max Seat #9 is the button
Seat 1: xTiMMeL ($1.58 in chips)
Seat 2: pokerHero1 ($2 in chips)
Seat 3: Tuz_i_Tuz ($2.92 in chips)
Seat 4: stavochka008 ($0.59 in chips)
Seat 5: nightwolfpro ($2.56 in chips)
Seat 6: anghelstefanesc ($1.81 in chips)
Seat 8: DrowsyDays ($4.15 in chips)
Seat 9: LipDoom ($0.76 in chips)
xTiMMeL: posts small blind $0.01
pokerHero1: posts big blind $0.02
*** HOLE CARDS ***
Dealt to pokerHero1 [Ks 9c]
Tuz_i_Tuz: raises $0.04 to $0.06
stavochka008: folds
nightwolfpro: calls $0.06
anghelstefanesc: folds
DrowsyDays: folds
LipDoom: folds
LipDoom leaves the table
Any2197 joins the table at seat #9
xTiMMeL: calls $0.05
pokerHero1: folds
*** FLOP *** [2d 9d Kd]
xTiMMeL: bets $0.10
Tuz_i_Tuz: folds
nightwolfpro: folds
Uncalled bet ($0.10) returned to xTiMMeL
xTiMMeL collected $0.19 from pot
xTiMMeL: doesn't show hand
*** SUMMARY ***
Total pot $0.20 | Rake $0.01
Board [2d 9d Kd]
Seat 1: xTiMMeL (small blind) collected ($0.19)
Seat 2: pokerHero1 (big blind) folded before Flop
Seat 3: Tuz_i_Tuz folded on the Flop
Seat 4: stavochka008 folded before Flop (didn't bet)
Seat 5: nightwolfpro folded on the Flop
Seat 6: anghelstefanesc folded before Flop (didn't bet)
Seat 8: DrowsyDays folded before Flop (didn't bet)
Seat 9: LipDoom (button) folded before Flop (didn't bet)



PokerStars Hand #212511754843:  Hold'em No Limit ($0.01/$0.02 USD) - 2020/04/22 12:51:17 ET
Table 'Jena II' 9-max Seat #1 is the button
Seat 1: xTiMMeL ($1.71 in chips)
Seat 2: pokerHero1 ($1.98 in chips)
Seat 3: Tuz_i_Tuz ($2.86 in chips)
Seat 4: stavochka008 ($0.59 in chips)
Seat 5: nightwolfpro ($2.50 in chips)
Seat 6: anghelstefanesc ($1.81 in chips)
Seat 8: DrowsyDays ($4.15 in chips)
Seat 9: Any2197 ($1.30 in chips)
pokerHero1: posts small blind $0.01
Tuz_i_Tuz: posts big blind $0.02
Any2197: posts big blind $0.02
*** HOLE CARDS ***
Dealt to pokerHero1 [8s Qh]
stavochka008: raises $0.04 to $0.06
nightwolfpro: folds
anghelstefanesc: calls $0.06
DrowsyDays: folds
Any2197: folds
xTiMMeL: folds
pokerHero1: folds
Tuz_i_Tuz: folds
*** FLOP *** [5h 6h 3c]
stavochka008: bets $0.10
anghelstefanesc: calls $0.10
*** TURN *** [5h 6h 3c] [Jh]
stavochka008: bets $0.12
anghelstefanesc: raises $0.60 to $0.72
stavochka008: folds
Uncalled bet ($0.60) returned to anghelstefanesc
anghelstefanesc collected $0.59 from pot
anghelstefanesc: doesn't show hand
*** SUMMARY ***
Total pot $0.61 | Rake $0.02
Board [5h 6h 3c Jh]
Seat 1: xTiMMeL (button) folded before Flop (didn't bet)
Seat 2: pokerHero1 (small blind) folded before Flop
Seat 3: Tuz_i_Tuz (big blind) folded before Flop
Seat 4: stavochka008 folded on the Turn
Seat 5: nightwolfpro folded before Flop (didn't bet)
Seat 6: anghelstefanesc collected ($0.59)
Seat 8: DrowsyDays folded before Flop (didn't bet)
Seat 9: Any2197 folded before Flop (didn't bet)



PokerStars Hand #212511803575:  Hold'em No Limit ($0.01/$0.02 USD) - 2020/04/22 12:52:10 ET
Table 'Jena II' 9-max Seat #2 is the button
Seat 1: xTiMMeL ($1.71 in chips)
Seat 2: pokerHero1 ($1.97 in chips)
Seat 3: Tuz_i_Tuz ($2.84 in chips)
Seat 4: stavochka008 ($0.31 in chips)
Seat 5: nightwolfpro ($2.50 in chips)
Seat 6: anghelstefanesc ($2.12 in chips)
Seat 8: DrowsyDays ($4.15 in chips)
Seat 9: Any2197 ($1.28 in chips)
Tuz_i_Tuz: posts small blind $0.01
stavochka008: posts big blind $0.02
*** HOLE CARDS ***
Dealt to pokerHero1 [As 8h]
nightwolfpro: folds
anghelstefanesc: calls $0.02
DrowsyDays: folds
Any2197: folds
xTiMMeL: calls $0.02
pokerHero1: raises $0.08 to $0.10
Tuz_i_Tuz: folds
stavochka008: calls $0.08
anghelstefanesc: calls $0.08
xTiMMeL: folds
*** FLOP *** [5h 6h Jd]
stavochka008: checks
anghelstefanesc: checks
pokerHero1: bets $0.18
stavochka008: folds
anghelstefanesc: folds
Uncalled bet ($0.18) returned to pokerHero1
pokerHero1 collected $0.32 from pot
pokerHero1: doesn't show hand
*** SUMMARY ***
Total pot $0.33 | Rake $0.01
Board [5h 6h Jd]
Seat 1: xTiMMeL folded before Flop
Seat 2: pokerHero1 (button) collected ($0.32)
Seat 3: Tuz_i_Tuz (small blind) folded before Flop
Seat 4: stavochka008 (big blind) folded on the Flop
Seat 5: nightwolfpro folded before Flop (didn't bet)
Seat 6: anghelstefanesc folded on the Flop
Seat 8: DrowsyDays folded before Flop (didn't bet)
Seat 9: Any2197 folded before Flop (didn't bet)



PokerStars Hand #212511858244:  Hold'em No Limit ($0.01/$0.02 USD) - 2020/04/22 12:53:10 ET
Table 'Jena II' 9-max Seat #3 is the button
Seat 1: xTiMMeL ($1.69 in chips)
Seat 2: pokerHero1 ($2.19 in chips)
Seat 3: Tuz_i_Tuz ($2.83 in chips)
Seat 4: stavochka008 ($0.21 in chips)
Seat 5: nightwolfpro ($2.50 in chips)
Seat 6: anghelstefanesc ($2.02 in chips)
Seat 8: DrowsyDays ($4.15 in chips)
Seat 9: Any2197 ($1.28 in chips)
stavochka008: posts small blind $0.01
nightwolfpro: posts big blind $0.02
*** HOLE CARDS ***
Dealt to pokerHero1 [6s Qh]
anghelstefanesc: folds
DrowsyDays: folds
Any2197: folds
xTiMMeL: folds
pokerHero1: folds
Tuz_i_Tuz: folds
stavochka008: raises $0.02 to $0.04
nightwolfpro: folds
Uncalled bet ($0.02) returned to stavochka008
stavochka008 collected $0.04 from pot
*** SUMMARY ***
Total pot $0.04 | Rake $0
Seat 1: xTiMMeL folded before Flop (didn't bet)
Seat 2: pokerHero1 folded before Flop (didn't bet)
Seat 3: Tuz_i_Tuz (button) folded before Flop (didn't bet)
Seat 4: stavochka008 (small blind) collected ($0.04)
Seat 5: nightwolfpro (big blind) folded before Flop
Seat 6: anghelstefanesc folded before Flop (didn't bet)
Seat 8: DrowsyDays folded before Flop (didn't bet)
Seat 9: Any2197 folded before Flop (didn't bet)



PokerStars Hand #212511872660:  Hold'em No Limit ($0.01/$0.02 USD) - 2020/04/22 12:53:26 ET
Table 'Jena II' 9-max Seat #4 is the button
Seat 1: xTiMMeL ($1.69 in chips)
Seat 2: pokerHero1 ($2.19 in chips)
Seat 3: Tuz_i_Tuz ($2.83 in chips)
Seat 4: stavochka008 ($0.23 in chips)
Seat 5: nightwolfpro ($2.48 in chips)
Seat 6: anghelstefanesc ($2.02 in chips)
Seat 8: DrowsyDays ($4.15 in chips)
Seat 9: Any2197 ($1.28 in chips)
nightwolfpro: posts small blind $0.01
anghelstefanesc: posts big blind $0.02
*** HOLE CARDS ***
Dealt to pokerHero1 [3d 8s]
DrowsyDays: folds
Any2197: folds
xTiMMeL has timed out
xTiMMeL: folds
pokerHero1: folds
Tuz_i_Tuz: folds
stavochka008: folds
nightwolfpro: folds
Uncalled bet ($0.01) returned to anghelstefanesc
anghelstefanesc collected $0.02 from pot
anghelstefanesc: doesn't show hand
*** SUMMARY ***
Total pot $0.02 | Rake $0
Seat 1: xTiMMeL folded before Flop (didn't bet)
Seat 2: pokerHero1 folded before Flop (didn't bet)
Seat 3: Tuz_i_Tuz folded before Flop (didn't bet)
Seat 4: stavochka008 (button) folded before Flop (didn't bet)
Seat 5: nightwolfpro (small blind) folded before Flop
Seat 6: anghelstefanesc (big blind) collected ($0.02)
Seat 8: DrowsyDays folded before Flop (didn't bet)
Seat 9: Any2197 folded before Flop (didn't bet)



PokerStars Hand #212511893274:  Hold'em No Limit ($0.01/$0.02 USD) - 2020/04/22 12:53:49 ET
Table 'Jena II' 9-max Seat #5 is the button
Seat 1: xTiMMeL ($1.69 in chips)
Seat 2: pokerHero1 ($2.19 in chips)
Seat 3: Tuz_i_Tuz ($2.83 in chips)
Seat 4: stavochka008 ($0.23 in chips)
Seat 5: nightwolfpro ($2.47 in chips)
Seat 6: anghelstefanesc ($2.03 in chips)
Seat 8: DrowsyDays ($4.15 in chips)
Seat 9: Any2197 ($1.28 in chips)
anghelstefanesc: posts small blind $0.01
DrowsyDays: posts big blind $0.02
*** HOLE CARDS ***
Dealt to pokerHero1 [3d 4d]
Any2197: folds
xTiMMeL: folds
pokerHero1: folds
Tuz_i_Tuz: raises $0.05 to $0.07
stavochka008: folds
nightwolfpro: folds
anghelstefanesc: folds
DrowsyDays: folds
Uncalled bet ($0.05) returned to Tuz_i_Tuz
Tuz_i_Tuz collected $0.05 from pot
rkmn121 was removed from the table for failing to post
rkmn121 leaves the table
Tuz_i_Tuz: doesn't show hand
*** SUMMARY ***
Total pot $0.05 | Rake $0
Seat 1: xTiMMeL folded before Flop (didn't bet)
Seat 2: pokerHero1 folded before Flop (didn't bet)
Seat 3: Tuz_i_Tuz collected ($0.05)
Seat 4: stavochka008 folded before Flop (didn't bet)
Seat 5: nightwolfpro (button) folded before Flop (didn't bet)
Seat 6: anghelstefanesc (small blind) folded before Flop
Seat 8: DrowsyDays (big blind) folded before Flop
Seat 9: Any2197 folded before Flop (didn't bet)



PokerStars Hand #212511920071:  Hold'em No Limit ($0.01/$0.02 USD) - 2020/04/22 12:54:19 ET
Table 'Jena II' 9-max Seat #6 is the button
Seat 1: xTiMMeL ($1.69 in chips)
Seat 2: pokerHero1 ($2.19 in chips)
Seat 3: Tuz_i_Tuz ($2.86 in chips)
Seat 4: stavochka008 ($0.23 in chips)
Seat 5: nightwolfpro ($2.47 in chips)
Seat 6: anghelstefanesc ($2.02 in chips)
Seat 8: DrowsyDays ($4.13 in chips)
Seat 9: Any2197 ($1.28 in chips)
DrowsyDays: posts small blind $0.01
Any2197: posts big blind $0.02
*** HOLE CARDS ***
Dealt to pokerHero1 [4c 9d]
xTiMMeL: calls $0.02
pokerHero1: folds
Tuz_i_Tuz: folds
stavochka008: folds
nightwolfpro: folds
anghelstefanesc: raises $0.10 to $0.12
Stefan310191 joins the table at seat #7
DrowsyDays: folds
Any2197: folds
xTiMMeL: folds
Uncalled bet ($0.10) returned to anghelstefanesc
anghelstefanesc collected $0.07 from pot
*** SUMMARY ***
Total pot $0.07 | Rake $0
Seat 1: xTiMMeL folded before Flop
Seat 2: pokerHero1 folded before Flop (didn't bet)
Seat 3: Tuz_i_Tuz folded before Flop (didn't bet)
Seat 4: stavochka008 folded before Flop (didn't bet)
Seat 5: nightwolfpro folded before Flop (didn't bet)
Seat 6: anghelstefanesc (button) collected ($0.07)
Seat 8: DrowsyDays (small blind) folded before Flop
Seat 9: Any2197 (big blind) folded before Flop



PokerStars Hand #212511960214:  Hold'em No Limit ($0.01/$0.02 USD) - 2020/04/22 12:55:03 ET
Table 'Jena II' 9-max Seat #8 is the button
Seat 1: xTiMMeL ($1.67 in chips)
Seat 2: pokerHero1 ($2.19 in chips)
Seat 3: Tuz_i_Tuz ($2.86 in chips)
Seat 4: stavochka008 ($0.23 in chips)
Seat 5: nightwolfpro ($2.47 in chips)
Seat 6: anghelstefanesc ($2.07 in chips)
Seat 8: DrowsyDays ($4.12 in chips)
Seat 9: Any2197 ($1.26 in chips)
Any2197: posts small blind $0.01
xTiMMeL: posts big blind $0.02
Stefan310191: sits out
*** HOLE CARDS ***
Dealt to pokerHero1 [3d 7c]
pokerHero1: folds
Tuz_i_Tuz: raises $0.04 to $0.06
stavochka008: folds
nightwolfpro: folds
anghelstefanesc: calls $0.06
DrowsyDays: folds
Any2197: folds
xTiMMeL: raises $0.04 to $0.10
Tuz_i_Tuz: calls $0.04
anghelstefanesc: calls $0.04
*** FLOP *** [Ts 9c 5s]
xTiMMeL: checks
Tuz_i_Tuz: bets $0.16
anghelstefanesc: calls $0.16
xTiMMeL: raises $0.16 to $0.32
Tuz_i_Tuz: calls $0.16
anghelstefanesc: calls $0.16
*** TURN *** [Ts 9c 5s] [Th]
xTiMMeL: checks
Tuz_i_Tuz: checks
anghelstefanesc: bets $0.62
xTiMMeL: calls $0.62
Tuz_i_Tuz: folds
*** RIVER *** [Ts 9c 5s Th] [8h]
xTiMMeL: checks
anghelstefanesc: bets $0.44
xTiMMeL: calls $0.44
*** SHOW DOWN ***
anghelstefanesc: shows [Td Ah] (three of a kind, Tens)
xTiMMeL: mucks hand
anghelstefanesc collected $3.27 from pot
*** SUMMARY ***
Total pot $3.39 | Rake $0.12
Board [Ts 9c 5s Th 8h]
Seat 1: xTiMMeL (big blind) mucked [As Qs]
Seat 2: pokerHero1 folded before Flop (didn't bet)
Seat 3: Tuz_i_Tuz folded on the Turn
Seat 4: stavochka008 folded before Flop (didn't bet)
Seat 5: nightwolfpro folded before Flop (didn't bet)
Seat 6: anghelstefanesc showed [Td Ah] and won ($3.27) with three of a kind, Tens
Seat 8: DrowsyDays (button) folded before Flop (didn't bet)
Seat 9: Any2197 (small blind) folded before Flop



PokerStars Hand #212512042005:  Hold'em No Limit ($0.01/$0.02 USD) - 2020/04/22 12:56:53 ET
Table 'Jena II' 9-max Seat #9 is the button
Seat 1: xTiMMeL ($0.19 in chips)
Seat 2: pokerHero1 ($2.19 in chips)
Seat 3: Tuz_i_Tuz ($2.44 in chips)
Seat 4: stavochka008 ($0.23 in chips)
Seat 5: nightwolfpro ($2.47 in chips)
Seat 6: anghelstefanesc ($3.86 in chips)
Seat 7: Stefan310191 ($2 in chips)
Seat 8: DrowsyDays ($4.12 in chips)
Seat 9: Any2197 ($1.25 in chips)
xTiMMeL: posts small blind $0.01
pokerHero1: posts big blind $0.02
Stefan310191: posts big blind $0.02
*** HOLE CARDS ***
Dealt to pokerHero1 [4h Qs]
Tuz_i_Tuz: folds
stavochka008: folds
nightwolfpro: calls $0.02
anghelstefanesc: calls $0.02
Stefan310191: checks
DrowsyDays: folds
Any2197: folds
xTiMMeL: raises $0.17 to $0.19 and is all-in
pokerHero1: folds
nightwolfpro: folds
anghelstefanesc: calls $0.17
Stefan310191: calls $0.17
*** FLOP *** [4c 8h Th]
anghelstefanesc: checks
Stefan310191: checks
*** TURN *** [4c 8h Th] [9s]
anghelstefanesc: checks
Stefan310191: checks
*** RIVER *** [4c 8h Th 9s] [6s]
anghelstefanesc: checks
Stefan310191: bets $0.22
anghelstefanesc: folds
Uncalled bet ($0.22) returned to Stefan310191
*** SHOW DOWN ***
Stefan310191: shows [2d 7c] (a straight, Six to Ten)
xTiMMeL: shows [5s 5h] (a pair of Fives)
Stefan310191 collected $0.59 from pot
*** SUMMARY ***
Total pot $0.61 | Rake $0.02
Board [4c 8h Th 9s 6s]
Seat 1: xTiMMeL (small blind) showed [5s 5h] and lost with a pair of Fives
Seat 2: pokerHero1 (big blind) folded before Flop
Seat 3: Tuz_i_Tuz folded before Flop (didn't bet)
Seat 4: stavochka008 folded before Flop (didn't bet)
Seat 5: nightwolfpro folded before Flop
Seat 6: anghelstefanesc folded on the River
Seat 7: Stefan310191 showed [2d 7c] and won ($0.59) with a straight, Six to Ten
Seat 8: DrowsyDays folded before Flop (didn't bet)
Seat 9: Any2197 (button) folded before Flop (didn't bet)



PokerStars Hand #212512091259:  Hold'em No Limit ($0.01/$0.02 USD) - 2020/04/22 12:58:03 ET
Table 'Jena II' 9-max Seat #2 is the button
Seat 2: pokerHero1 ($2.17 in chips)
Seat 3: Tuz_i_Tuz ($2.44 in chips)
Seat 4: stavochka008 ($0.23 in chips)
Seat 5: nightwolfpro ($2.45 in chips)
Seat 6: anghelstefanesc ($3.67 in chips)
Seat 7: Stefan310191 ($2.40 in chips)
Seat 8: DrowsyDays ($4.12 in chips)
Seat 9: Any2197 ($1.25 in chips)
Tuz_i_Tuz: posts small blind $0.01
stavochka008: posts big blind $0.02
*** HOLE CARDS ***
Dealt to pokerHero1 [Kc Ah]
nightwolfpro: folds
anghelstefanesc: calls $0.02
Stefan310191: raises $0.02 to $0.04
DrowsyDays: folds
Any2197: folds
pokerHero1: raises $0.16 to $0.20
Tuz_i_Tuz: folds
stavochka008: folds
anghelstefanesc: folds
Stefan310191: calls $0.16
*** FLOP *** [3c Th 7c]
xTiMMeL is disconnected
Stefan310191: checks
pokerHero1: bets $0.26
Stefan310191: calls $0.26
*** TURN *** [3c Th 7c] [4s]
Stefan310191: checks
pokerHero1: checks
*** RIVER *** [3c Th 7c 4s] [Qd]
Stefan310191: bets $0.94
pokerHero1: folds
Uncalled bet ($0.94) returned to Stefan310191
Stefan310191 collected $0.94 from pot
Stefan310191: doesn't show hand
*** SUMMARY ***
Total pot $0.97 | Rake $0.03
Board [3c Th 7c 4s Qd]
Seat 2: pokerHero1 (button) folded on the River
Seat 3: Tuz_i_Tuz (small blind) folded before Flop
Seat 4: stavochka008 (big blind) folded before Flop
Seat 5: nightwolfpro folded before Flop (didn't bet)
Seat 6: anghelstefanesc folded before Flop
Seat 7: Stefan310191 collected ($0.94)
Seat 8: DrowsyDays folded before Flop (didn't bet)
Seat 9: Any2197 folded before Flop (didn't bet)



PokerStars Hand #212512147770:  Hold'em No Limit ($0.01/$0.02 USD) - 2020/04/22 12:59:23 ET
Table 'Jena II' 9-max Seat #3 is the button
Seat 2: pokerHero1 ($1.71 in chips)
Seat 3: Tuz_i_Tuz ($2.43 in chips)
Seat 4: stavochka008 ($0.21 in chips)
Seat 5: nightwolfpro ($2.45 in chips)
Seat 6: anghelstefanesc ($3.65 in chips)
Seat 7: Stefan310191 ($2.88 in chips)
Seat 8: DrowsyDays ($4.12 in chips)
Seat 9: Any2197 ($1.25 in chips)
stavochka008: posts small blind $0.01
nightwolfpro: posts big blind $0.02
*** HOLE CARDS ***
Dealt to pokerHero1 [7c Qc]
anghelstefanesc: folds
Stefan310191: raises $0.18 to $0.20
DrowsyDays: folds
Any2197: folds
pokerHero1: folds
Tuz_i_Tuz: folds
Tuz_i_Tuz leaves the table
stavochka008: raises $0.01 to $0.21 and is all-in
nightwolfpro: calls $0.19
Stefan310191: calls $0.01
*** FLOP *** [2s Jh 3d]
nightwolfpro: checks
Stefan310191: bets $0.31
nightwolfpro: folds
Uncalled bet ($0.31) returned to Stefan310191
*** TURN *** [2s Jh 3d] [2h]
*** RIVER *** [2s Jh 3d 2h] [7s]
*** SHOW DOWN ***
stavochka008: shows [Kc As] (a pair of Deuces)
Stefan310191: shows [Kd Ah] (a pair of Deuces)
stavochka008 collected $0.31 from pot
Stefan310191 collected $0.30 from pot
*** SUMMARY ***
Total pot $0.63 | Rake $0.02
Board [2s Jh 3d 2h 7s]
Seat 2: pokerHero1 folded before Flop (didn't bet)
Seat 3: Tuz_i_Tuz (button) folded before Flop (didn't bet)
Seat 4: stavochka008 (small blind) showed [Kc As] and won ($0.31) with a pair of Deuces
Seat 5: nightwolfpro (big blind) folded on the Flop
Seat 6: anghelstefanesc folded before Flop (didn't bet)
Seat 7: Stefan310191 showed [Kd Ah] and won ($0.30) with a pair of Deuces
Seat 8: DrowsyDays folded before Flop (didn't bet)
Seat 9: Any2197 folded before Flop (didn't bet)



PokerStars Hand #212512176645:  Hold'em No Limit ($0.01/$0.02 USD) - 2020/04/22 13:00:04 ET
Table 'Jena II' 9-max Seat #4 is the button
Seat 2: pokerHero1 ($2 in chips)
Seat 4: stavochka008 ($0.31 in chips)
Seat 5: nightwolfpro ($2.24 in chips)
Seat 6: anghelstefanesc ($3.65 in chips)
Seat 7: Stefan310191 ($2.97 in chips)
Seat 8: DrowsyDays ($4.12 in chips)
Seat 9: Any2197 ($1.25 in chips)
nightwolfpro: posts small blind $0.01
anghelstefanesc: posts big blind $0.02
*** HOLE CARDS ***
Dealt to pokerHero1 [3h 3d]
Stefan310191: raises $0.04 to $0.06
Undispute477 joins the table at seat #3
DrowsyDays: folds
Any2197: folds
Any2197 leaves the table
pokerHero1: calls $0.06
stavochka008: folds
nightwolfpro: folds
anghelstefanesc: calls $0.04
*** FLOP *** [4c 2h 5s]
anghelstefanesc: checks
Stefan310191: bets $0.18
pokerHero1: calls $0.18
anghelstefanesc: folds
*** TURN *** [4c 2h 5s] [2s]
Stefan310191: checks
pokerHero1: bets $0.54
Stefan310191: folds
Uncalled bet ($0.54) returned to pokerHero1
Older618 joins the table at seat #9
pokerHero1 collected $0.53 from pot
pokerHero1: doesn't show hand
*** SUMMARY ***
Total pot $0.55 | Rake $0.02
Board [4c 2h 5s 2s]
Seat 2: pokerHero1 collected ($0.53)
Seat 4: stavochka008 (button) folded before Flop (didn't bet)
Seat 5: nightwolfpro (small blind) folded before Flop
Seat 6: anghelstefanesc (big blind) folded on the Flop
Seat 7: Stefan310191 folded on the Turn
Seat 8: DrowsyDays folded before Flop (didn't bet)
Seat 9: Any2197 folded before Flop (didn't bet)



PokerStars Hand #212512240763:  Hold'em No Limit ($0.01/$0.02 USD) - 2020/04/22 13:01:17 ET
Table 'Jena II' 9-max Seat #5 is the button
Seat 2: pokerHero1 ($2.29 in chips)
Seat 4: stavochka008 ($0.31 in chips)
Seat 5: nightwolfpro ($2.23 in chips)
Seat 6: anghelstefanesc ($3.59 in chips)
Seat 7: Stefan310191 ($2.73 in chips)
Seat 8: DrowsyDays ($4.12 in chips)
anghelstefanesc: posts small blind $0.01
Stefan310191: posts big blind $0.02
Older618: sits out
Undispute477: sits out
*** HOLE CARDS ***
Dealt to pokerHero1 [5d 2h]
DrowsyDays: folds
pokerHero1: folds
stavochka008: raises $0.02 to $0.04
nightwolfpro: folds
anghelstefanesc: folds
Stefan310191: calls $0.02
*** FLOP *** [Kd Tc 7c]
Stefan310191: checks
stavochka008: bets $0.12
Stefan310191: folds
Uncalled bet ($0.12) returned to stavochka008
stavochka008 collected $0.09 from pot
stavochka008: doesn't show hand
*** SUMMARY ***
Total pot $0.09 | Rake $0
Board [Kd Tc 7c]
Seat 2: pokerHero1 folded before Flop (didn't bet)
Seat 4: stavochka008 collected ($0.09)
Seat 5: nightwolfpro (button) folded before Flop (didn't bet)
Seat 6: anghelstefanesc (small blind) folded before Flop
Seat 7: Stefan310191 (big blind) folded on the Flop
Seat 8: DrowsyDays folded before Flop (didn't bet)



PokerStars Hand #212512269069:  Hold'em No Limit ($0.01/$0.02 USD) - 2020/04/22 13:01:50 ET
Table 'Jena II' 9-max Seat #6 is the button
Seat 2: pokerHero1 ($2.29 in chips)
Seat 4: stavochka008 ($0.36 in chips)
Seat 5: nightwolfpro ($2.23 in chips)
Seat 6: anghelstefanesc ($3.58 in chips)
Seat 7: Stefan310191 ($2.69 in chips)
Seat 8: DrowsyDays ($4.12 in chips)
Stefan310191: posts small blind $0.01
DrowsyDays: posts big blind $0.02
Older618: sits out
Undispute477: sits out
*** HOLE CARDS ***
Dealt to pokerHero1 [Th Tc]
pokerHero1: raises $0.06 to $0.08
stavochka008: folds
nightwolfpro: folds
anghelstefanesc: folds
Stefan310191: calls $0.07
DrowsyDays: folds
*** FLOP *** [Ts 6d Qs]
Stefan310191: checks
pokerHero1: bets $0.15
Stefan310191: calls $0.15
*** TURN *** [Ts 6d Qs] [Qc]
Stefan310191: checks
pokerHero1: checks
*** RIVER *** [Ts 6d Qs Qc] [3c]
Stefan310191: bets $0.46
pokerHero1: raises $0.76 to $1.22
Stefan310191: folds
Uncalled bet ($0.76) returned to pokerHero1
pokerHero1 collected $1.35 from pot
pokerHero1: doesn't show hand
*** SUMMARY ***
Total pot $1.40 | Rake $0.05
Board [Ts 6d Qs Qc 3c]
Seat 2: pokerHero1 collected ($1.35)
Seat 4: stavochka008 folded before Flop (didn't bet)
Seat 5: nightwolfpro folded before Flop (didn't bet)
Seat 6: anghelstefanesc (button) folded before Flop (didn't bet)
Seat 7: Stefan310191 (small blind) folded on the River
Seat 8: DrowsyDays (big blind) folded before Flop



PokerStars Hand #212512348678:  Hold'em No Limit ($0.01/$0.02 USD) - 2020/04/22 13:03:16 ET
Table 'Jena II' 9-max Seat #7 is the button
Seat 2: pokerHero1 ($2.95 in chips)
Seat 4: stavochka008 ($0.36 in chips)
Seat 5: nightwolfpro ($2.23 in chips)
Seat 6: anghelstefanesc ($3.58 in chips)
Seat 7: Stefan310191 ($2 in chips)
Seat 8: DrowsyDays ($4.10 in chips)
Seat 9: Older618 ($2 in chips)
DrowsyDays: posts small blind $0.01
Older618: posts big blind $0.02
Undispute477: sits out
*** HOLE CARDS ***
Dealt to pokerHero1 [5d Jd]
pokerHero1: folds
stavochka008: raises $0.02 to $0.04
nightwolfpro: folds
anghelstefanesc: calls $0.04
Stefan310191: raises $0.08 to $0.12
DrowsyDays: calls $0.11
Older618: folds
stavochka008: raises $0.24 to $0.36 and is all-in
anghelstefanesc: folds
Stefan310191: calls $0.24
DrowsyDays: folds
*** FLOP *** [5c 2c 9s]
*** TURN *** [5c 2c 9s] [3h]
*** RIVER *** [5c 2c 9s 3h] [2s]
*** SHOW DOWN ***
stavochka008: shows [Ac Kc] (a pair of Deuces)
Stefan310191: shows [Qh Jc] (a pair of Deuces - lower kicker)
stavochka008 cashed out the hand for $0.57 | Cash Out Fee $0.01
*** SUMMARY ***
Total pot $0.90 | Rake $0.03
Board [5c 2c 9s 3h 2s]
Seat 2: pokerHero1 folded before Flop (didn't bet)
Seat 4: stavochka008 showed [Ac Kc] and won ($0.87) with a pair of Deuces (pot not awarded as player cashed out)
Seat 5: nightwolfpro folded before Flop (didn't bet)
Seat 6: anghelstefanesc folded before Flop
Seat 7: Stefan310191 (button) showed [Qh Jc] and lost with a pair of Deuces
Seat 8: DrowsyDays (small blind) folded before Flop
Seat 9: Older618 (big blind) folded before Flop



PokerStars Hand #212512409696:  Hold'em No Limit ($0.01/$0.02 USD) - 2020/04/22 13:04:21 ET
Table 'Jena II' 9-max Seat #8 is the button
Seat 2: pokerHero1 ($2.95 in chips)
Seat 4: stavochka008 ($0.57 in chips)
Seat 5: nightwolfpro ($2.23 in chips)
Seat 6: anghelstefanesc ($3.54 in chips)
Seat 7: Stefan310191 ($1.64 in chips)
Seat 8: DrowsyDays ($3.98 in chips)
Seat 9: Older618 ($2 in chips)
Older618: posts small blind $0.01
pokerHero1: posts big blind $0.02
Undispute477: sits out
*** HOLE CARDS ***
Dealt to pokerHero1 [Kc 3h]
stavochka008: calls $0.02
nightwolfpro: folds
anghelstefanesc has timed out
anghelstefanesc: folds
Stefan310191: calls $0.02
DrowsyDays: folds
Older618: raises $0.07 to $0.09
pokerHero1: folds
stavochka008: folds
Stefan310191: calls $0.07
*** FLOP *** [6s 2h 5c]
Older618: bets $0.14
Stefan310191: raises $0.46 to $0.60
Older618: folds
Uncalled bet ($0.46) returned to Stefan310191
Stefan310191 collected $0.48 from pot
Stefan310191: doesn't show hand
*** SUMMARY ***
Total pot $0.50 | Rake $0.02
Board [6s 2h 5c]
Seat 2: pokerHero1 (big blind) folded before Flop
Seat 4: stavochka008 folded before Flop
Seat 5: nightwolfpro folded before Flop (didn't bet)
Seat 6: anghelstefanesc folded before Flop (didn't bet)
Seat 7: Stefan310191 collected ($0.48)
Seat 8: DrowsyDays (button) folded before Flop (didn't bet)
Seat 9: Older618 (small blind) folded on the Flop



PokerStars Hand #212512474945:  Hold'em No Limit ($0.01/$0.02 USD) - 2020/04/22 13:05:30 ET
Table 'Jena II' 9-max Seat #9 is the button
Seat 2: pokerHero1 ($2.93 in chips)
Seat 3: Undispute477 ($1.75 in chips)
Seat 5: nightwolfpro ($2.23 in chips)
Seat 6: anghelstefanesc ($3.54 in chips)
Seat 7: Stefan310191 ($1.89 in chips)
Seat 8: DrowsyDays ($3.98 in chips)
Seat 9: Older618 ($2 in chips)
pokerHero1: posts small blind $0.01
Undispute477: posts big blind $0.02
*** HOLE CARDS ***
Dealt to pokerHero1 [7d Qs]
nightwolfpro: raises $0.04 to $0.06
anghelstefanesc: folds
Stefan310191: raises $0.12 to $0.18
DrowsyDays: folds
Older618: calls $0.18
pokerHero1: folds
Undispute477: folds
nightwolfpro: folds
*** FLOP *** [As Th 5h]
Stefan310191: bets $0.43
Older618: raises $0.86 to $1.29
Stefan310191: raises $0.42 to $1.71 and is all-in
Older618: calls $0.42
*** TURN *** [As Th 5h] [3c]
*** RIVER *** [As Th 5h 3c] [6h]
*** SHOW DOWN ***
Stefan310191: shows [Ah Jd] (a pair of Aces)
Older618: shows [Kd Jc] (high card Ace)
Stefan310191 collected $3.73 from pot
*** SUMMARY ***
Total pot $3.87 | Rake $0.14
Board [As Th 5h 3c 6h]
Seat 2: pokerHero1 (small blind) folded before Flop
Seat 3: Undispute477 (big blind) folded before Flop
Seat 5: nightwolfpro folded before Flop
Seat 6: anghelstefanesc folded before Flop (didn't bet)
Seat 7: Stefan310191 showed [Ah Jd] and won ($3.73) with a pair of Aces
Seat 8: DrowsyDays folded before Flop (didn't bet)
Seat 9: Older618 (button) showed [Kd Jc] and lost with high card Ace



PokerStars Hand #212512520988:  Hold'em No Limit ($0.01/$0.02 USD) - 2020/04/22 13:06:15 ET
Table 'Jena II' 9-max Seat #2 is the button
Seat 2: pokerHero1 ($2.92 in chips)
Seat 3: Undispute477 ($1.73 in chips)
Seat 6: anghelstefanesc ($3.54 in chips)
Seat 7: Stefan310191 ($3.73 in chips)
Seat 8: DrowsyDays ($3.98 in chips)
Undispute477: posts small blind $0.01
nightwolfpro: is sitting out
nightwolfpro leaves the table
anghelstefanesc: posts big blind $0.02
*** HOLE CARDS ***
Dealt to pokerHero1 [8h 9d]
Stefan310191: folds
DrowsyDays: folds
pokerHero1: folds
den1777den joins the table at seat #9
Undispute477: raises $0.08 to $0.10
LegizBayk joins the table at seat #5
anghelstefanesc: folds
Uncalled bet ($0.08) returned to Undispute477
Undispute477 collected $0.04 from pot
*** SUMMARY ***
Total pot $0.04 | Rake $0
Seat 2: pokerHero1 (button) folded before Flop (didn't bet)
Seat 3: Undispute477 (small blind) collected ($0.04)
Seat 6: anghelstefanesc (big blind) folded before Flop
Seat 7: Stefan310191 folded before Flop (didn't bet)
Seat 8: DrowsyDays folded before Flop (didn't bet)



PokerStars Hand #212512560026:  Hold'em No Limit ($0.01/$0.02 USD) - 2020/04/22 13:06:54 ET
Table 'Jena II' 9-max Seat #3 is the button
Seat 2: pokerHero1 ($2.92 in chips)
Seat 3: Undispute477 ($1.75 in chips)
Seat 6: anghelstefanesc ($3.52 in chips)
Seat 7: Stefan310191 ($3.73 in chips)
Seat 8: DrowsyDays ($3.98 in chips)
anghelstefanesc: posts small blind $0.01
Stefan310191: posts big blind $0.02
den1777den: sits out
*** HOLE CARDS ***
Dealt to pokerHero1 [As 9s]
DrowsyDays: folds
pokerHero1: raises $0.06 to $0.08
Undispute477: raises $0.16 to $0.24
anghelstefanesc: folds
Stefan310191: calls $0.22
pokerHero1: folds
*** FLOP *** [5d Tc 8c]
Stefan310191: checks
Undispute477: bets $0.54
Stefan310191: folds
Uncalled bet ($0.54) returned to Undispute477
Undispute477 collected $0.55 from pot
*** SUMMARY ***
Total pot $0.57 | Rake $0.02
Board [5d Tc 8c]
Seat 2: pokerHero1 folded before Flop
Seat 3: Undispute477 (button) collected ($0.55)
Seat 6: anghelstefanesc (small blind) folded before Flop
Seat 7: Stefan310191 (big blind) folded on the Flop
Seat 8: DrowsyDays folded before Flop (didn't bet)



PokerStars Hand #212512607311:  Hold'em No Limit ($0.01/$0.02 USD) - 2020/04/22 13:07:41 ET
Table 'Jena II' 9-max Seat #6 is the button
Seat 2: pokerHero1 ($2.84 in chips)
Seat 3: Undispute477 ($2.06 in chips)
Seat 5: LegizBayk ($0.80 in chips)
Seat 6: anghelstefanesc ($3.51 in chips)
Seat 8: DrowsyDays ($3.98 in chips)
Seat 9: den1777den ($1.60 in chips)
DrowsyDays: posts small blind $0.01
den1777den: posts big blind $0.02
LegizBayk: posts big blind $0.02
*** HOLE CARDS ***
Dealt to pokerHero1 [4d 3d]
pokerHero1: folds
Undispute477: folds
LegizBayk: checks
anghelstefanesc: calls $0.02
DrowsyDays: folds
den1777den: checks
*** FLOP *** [Kd 6h Jh]
den1777den: checks
LegizBayk: bets $0.02
anghelstefanesc: calls $0.02
den1777den: folds
*** TURN *** [Kd 6h Jh] [7c]
xTiMMeL was removed from the table for failing to post
xTiMMeL leaves the table
LegizBayk: bets $0.04
anghelstefanesc: calls $0.04
*** RIVER *** [Kd 6h Jh 7c] [7h]
LegizBayk: checks
anghelstefanesc: checks
*** SHOW DOWN ***
LegizBayk: shows [Jd 4s] (two pair, Jacks and Sevens)
anghelstefanesc: shows [8d Kh] (two pair, Kings and Sevens)
anghelstefanesc collected $0.18 from pot
*** SUMMARY ***
Total pot $0.19 | Rake $0.01
Board [Kd 6h Jh 7c 7h]
Seat 2: pokerHero1 folded before Flop (didn't bet)
Seat 3: Undispute477 folded before Flop (didn't bet)
Seat 5: LegizBayk showed [Jd 4s] and lost with two pair, Jacks and Sevens
Seat 6: anghelstefanesc (button) showed [8d Kh] and won ($0.18) with two pair, Kings and Sevens
Seat 8: DrowsyDays (small blind) folded before Flop
Seat 9: den1777den (big blind) folded on the Flop



PokerStars Hand #212512701176:  Hold'em No Limit ($0.01/$0.02 USD) - 2020/04/22 13:09:17 ET
Table 'Jena II' 9-max Seat #8 is the button
Seat 2: pokerHero1 ($2.84 in chips)
Seat 3: Undispute477 ($2.06 in chips)
Seat 5: LegizBayk ($0.72 in chips)
Seat 6: anghelstefanesc ($3.61 in chips)
Seat 8: DrowsyDays ($3.97 in chips)
Seat 9: den1777den ($1.58 in chips)
den1777den: posts small blind $0.01
pokerHero1: posts big blind $0.02
*** HOLE CARDS ***
Dealt to pokerHero1 [5h 7s]
Undispute477: folds
LegizBayk: folds
Zuludererste joins the table at seat #1
anghelstefanesc: folds
DrowsyDays: raises $0.04 to $0.06
den1777den: folds
pokerHero1: folds
Uncalled bet ($0.04) returned to DrowsyDays
DrowsyDays collected $0.05 from pot
DrowsyDays: doesn't show hand
*** SUMMARY ***
Total pot $0.05 | Rake $0
Seat 2: pokerHero1 (big blind) folded before Flop
Seat 3: Undispute477 folded before Flop (didn't bet)
Seat 5: LegizBayk folded before Flop (didn't bet)
Seat 6: anghelstefanesc folded before Flop (didn't bet)
Seat 8: DrowsyDays (button) collected ($0.05)
Seat 9: den1777den (small blind) folded before Flop



PokerStars Hand #212512725851:  Hold'em No Limit ($0.01/$0.02 USD) - 2020/04/22 13:09:43 ET
Table 'Jena II' 9-max Seat #9 is the button
Seat 2: pokerHero1 ($2.82 in chips)
Seat 3: Undispute477 ($2.06 in chips)
Seat 5: LegizBayk ($0.72 in chips)
Seat 6: anghelstefanesc ($3.61 in chips)
Seat 8: DrowsyDays ($4 in chips)
Seat 9: den1777den ($1.57 in chips)
pokerHero1: posts small blind $0.01
Undispute477: posts big blind $0.02
*** HOLE CARDS ***
Dealt to pokerHero1 [Kc 2h]
LegizBayk: folds
anghelstefanesc: calls $0.02
DrowsyDays: folds
den1777den: folds
pokerHero1: folds
Undispute477: checks
*** FLOP *** [5d Qd 8c]
Stefan310191 leaves the table
Undispute477: bets $0.04
anghelstefanesc: folds
Uncalled bet ($0.04) returned to Undispute477
Undispute477 collected $0.05 from pot
*** SUMMARY ***
Total pot $0.05 | Rake $0
Board [5d Qd 8c]
Seat 2: pokerHero1 (small blind) folded before Flop
Seat 3: Undispute477 (big blind) collected ($0.05)
Seat 5: LegizBayk folded before Flop (didn't bet)
Seat 6: anghelstefanesc folded on the Flop
Seat 8: DrowsyDays folded before Flop (didn't bet)
Seat 9: den1777den (button) folded before Flop (didn't bet)



PokerStars Hand #212512767984:  Hold'em No Limit ($0.01/$0.02 USD) - 2020/04/22 13:10:26 ET
Table 'Jena II' 9-max Seat #2 is the button
Seat 1: Zuludererste ($0.80 in chips)
Seat 2: pokerHero1 ($2.81 in chips)
Seat 3: Undispute477 ($2.09 in chips)
Seat 5: LegizBayk ($0.72 in chips)
Seat 6: anghelstefanesc ($3.59 in chips)
Seat 8: DrowsyDays ($4 in chips)
Seat 9: den1777den ($1.57 in chips)
Undispute477: posts small blind $0.01
LegizBayk: posts big blind $0.02
Zuludererste: posts big blind $0.02
*** HOLE CARDS ***
Dealt to pokerHero1 [5s Th]
anghelstefanesc: raises $0.02 to $0.04
DrowsyDays: folds
den1777den: folds
Zuludererste: calls $0.02
pokerHero1: folds
Undispute477: folds
LegizBayk: folds
*** FLOP *** [Qs Ac 3s]
anghelstefanesc: bets $0.11
Zuludererste: folds
Uncalled bet ($0.11) returned to anghelstefanesc
anghelstefanesc collected $0.11 from pot
anghelstefanesc: doesn't show hand
*** SUMMARY ***
Total pot $0.11 | Rake $0
Board [Qs Ac 3s]
Seat 1: Zuludererste folded on the Flop
Seat 2: pokerHero1 (button) folded before Flop (didn't bet)
Seat 3: Undispute477 (small blind) folded before Flop
Seat 5: LegizBayk (big blind) folded before Flop
Seat 6: anghelstefanesc collected ($0.11)
Seat 8: DrowsyDays folded before Flop (didn't bet)
Seat 9: den1777den folded before Flop (didn't bet)



PokerStars Hand #212512818922:  Hold'em No Limit ($0.01/$0.02 USD) - 2020/04/22 13:11:18 ET
Table 'Jena II' 9-max Seat #3 is the button
Seat 1: Zuludererste ($0.76 in chips)
Seat 2: pokerHero1 ($2.81 in chips)
Seat 3: Undispute477 ($2.08 in chips)
Seat 5: LegizBayk ($0.70 in chips)
Seat 6: anghelstefanesc ($3.66 in chips)
Seat 8: DrowsyDays ($4 in chips)
Seat 9: den1777den ($1.57 in chips)
LegizBayk: posts small blind $0.01
anghelstefanesc: posts big blind $0.02
*** HOLE CARDS ***
Dealt to pokerHero1 [4s 7d]
DrowsyDays: folds
Pedrueza.06 joins the table at seat #7
den1777den: folds
Zuludererste: folds
pokerHero1: folds
Undispute477: folds
LegizBayk: folds
Uncalled bet ($0.01) returned to anghelstefanesc
anghelstefanesc collected $0.02 from pot
*** SUMMARY ***
Total pot $0.02 | Rake $0
Seat 1: Zuludererste folded before Flop (didn't bet)
Seat 2: pokerHero1 folded before Flop (didn't bet)
Seat 3: Undispute477 (button) folded before Flop (didn't bet)
Seat 5: LegizBayk (small blind) folded before Flop
Seat 6: anghelstefanesc (big blind) collected ($0.02)
Seat 8: DrowsyDays folded before Flop (didn't bet)
Seat 9: den1777den folded before Flop (didn't bet)



PokerStars Hand #212512840591:  Hold'em No Limit ($0.01/$0.02 USD) - 2020/04/22 13:11:41 ET
Table 'Jena II' 9-max Seat #5 is the button
Seat 1: Zuludererste ($0.76 in chips)
Seat 2: pokerHero1 ($2.81 in chips)
Seat 3: Undispute477 ($2.08 in chips)
Seat 5: LegizBayk ($0.69 in chips)
Seat 6: anghelstefanesc ($3.67 in chips)
Seat 7: Pedrueza.06 ($0.80 in chips)
Seat 8: DrowsyDays ($4 in chips)
Seat 9: den1777den ($1.57 in chips)
anghelstefanesc: posts small blind $0.01
Pedrueza.06: posts big blind $0.02
*** HOLE CARDS ***
Dealt to pokerHero1 [6h 9s]
DrowsyDays: folds
den1777den: folds
Zuludererste: raises $0.02 to $0.04
pokerHero1: folds
Undispute477: folds
LegizBayk: calls $0.04
anghelstefanesc: calls $0.03
Pedrueza.06: calls $0.02
*** FLOP *** [Td Ts Qd]
anghelstefanesc: checks
Pedrueza.06: checks
Zuludererste: checks
LegizBayk: checks
*** TURN *** [Td Ts Qd] [7d]
anghelstefanesc: checks
Pedrueza.06: checks
Zuludererste: checks
LegizBayk: checks
*** RIVER *** [Td Ts Qd 7d] [Tc]
anghelstefanesc: checks
Pedrueza.06: bets $0.02
Zuludererste: calls $0.02
LegizBayk: folds
anghelstefanesc: calls $0.02
*** SHOW DOWN ***
Pedrueza.06: shows [3s Ah] (three of a kind, Tens)
Zuludererste: shows [5h 5s] (a full house, Tens full of Fives)
anghelstefanesc: shows [9c 7s] (a full house, Tens full of Sevens)
anghelstefanesc collected $0.21 from pot
*** SUMMARY ***
Total pot $0.22 | Rake $0.01
Board [Td Ts Qd 7d Tc]
Seat 1: Zuludererste showed [5h 5s] and lost with a full house, Tens full of Fives
Seat 2: pokerHero1 folded before Flop (didn't bet)
Seat 3: Undispute477 folded before Flop (didn't bet)
Seat 5: LegizBayk (button) folded on the River
Seat 6: anghelstefanesc (small blind) showed [9c 7s] and won ($0.21) with a full house, Tens full of Sevens
Seat 7: Pedrueza.06 (big blind) showed [3s Ah] and lost with three of a kind, Tens
Seat 8: DrowsyDays folded before Flop (didn't bet)
Seat 9: den1777den folded before Flop (didn't bet)



PokerStars Hand #212512949978:  Hold'em No Limit ($0.01/$0.02 USD) - 2020/04/22 13:13:33 ET
Table 'Jena II' 9-max Seat #6 is the button
Seat 1: Zuludererste ($0.70 in chips)
Seat 2: pokerHero1 ($2.81 in chips)
Seat 3: Undispute477 ($2.08 in chips)
Seat 4: stavochka008 ($0.55 in chips)
Seat 5: LegizBayk ($0.65 in chips)
Seat 6: anghelstefanesc ($3.82 in chips)
Seat 7: Pedrueza.06 ($0.74 in chips)
Seat 8: DrowsyDays ($4 in chips)
Seat 9: den1777den ($1.57 in chips)
Pedrueza.06: posts small blind $0.01
DrowsyDays: posts big blind $0.02
stavochka008: posts small & big blinds $0.03
*** HOLE CARDS ***
Dealt to pokerHero1 [2d Kc]
den1777den: folds
Zuludererste: calls $0.02
pokerHero1: folds
Undispute477: raises $0.10 to $0.12
stavochka008: folds
LegizBayk: folds
anghelstefanesc: folds
Pedrueza.06: folds
DrowsyDays: raises $0.20 to $0.32
Zuludererste: folds
Undispute477: calls $0.20
*** FLOP *** [3h Ts 6d]
DrowsyDays: bets $0.40
Undispute477: folds
Uncalled bet ($0.40) returned to DrowsyDays
DrowsyDays collected $0.68 from pot
DrowsyDays: doesn't show hand
*** SUMMARY ***
Total pot $0.70 | Rake $0.02
Board [3h Ts 6d]
Seat 1: Zuludererste folded before Flop
Seat 2: pokerHero1 folded before Flop (didn't bet)
Seat 3: Undispute477 folded on the Flop
Seat 4: stavochka008 folded before Flop (didn't bet)
Seat 5: LegizBayk folded before Flop (didn't bet)
Seat 6: anghelstefanesc (button) folded before Flop (didn't bet)
Seat 7: Pedrueza.06 (small blind) folded before Flop
Seat 8: DrowsyDays (big blind) collected ($0.68)
Seat 9: den1777den folded before Flop (didn't bet)



PokerStars Hand #212513013235:  Hold'em No Limit ($0.01/$0.02 USD) - 2020/04/22 13:14:35 ET
Table 'Jena II' 9-max Seat #7 is the button
Seat 1: Zuludererste ($0.68 in chips)
Seat 2: pokerHero1 ($2.81 in chips)
Seat 3: Undispute477 ($1.76 in chips)
Seat 4: stavochka008 ($0.52 in chips)
Seat 5: LegizBayk ($0.65 in chips)
Seat 6: anghelstefanesc ($3.82 in chips)
Seat 7: Pedrueza.06 ($0.73 in chips)
Seat 8: DrowsyDays ($4.36 in chips)
Seat 9: den1777den ($1.57 in chips)
DrowsyDays: posts small blind $0.01
den1777den: posts big blind $0.02
*** HOLE CARDS ***
Dealt to pokerHero1 [8s 8c]
Zuludererste: folds
pokerHero1: calls $0.02
Undispute477: raises $0.08 to $0.10
stavochka008: folds
LegizBayk: folds
anghelstefanesc: folds
Pedrueza.06: folds
DrowsyDays: folds
den1777den: folds
pokerHero1: folds
Uncalled bet ($0.08) returned to Undispute477
Undispute477 collected $0.07 from pot
*** SUMMARY ***
Total pot $0.07 | Rake $0
Seat 1: Zuludererste folded before Flop (didn't bet)
Seat 2: pokerHero1 folded before Flop
Seat 3: Undispute477 collected ($0.07)
Seat 4: stavochka008 folded before Flop (didn't bet)
Seat 5: LegizBayk folded before Flop (didn't bet)
Seat 6: anghelstefanesc folded before Flop (didn't bet)
Seat 7: Pedrueza.06 (button) folded before Flop (didn't bet)
Seat 8: DrowsyDays (small blind) folded before Flop
Seat 9: den1777den (big blind) folded before Flop



PokerStars Hand #212513048905:  Hold'em No Limit ($0.01/$0.02 USD) - 2020/04/22 13:15:12 ET
Table 'Jena II' 9-max Seat #8 is the button
Seat 1: Zuludererste ($0.68 in chips)
Seat 2: pokerHero1 ($2.79 in chips)
Seat 3: Undispute477 ($1.81 in chips)
Seat 4: stavochka008 ($0.52 in chips)
Seat 5: LegizBayk ($0.65 in chips)
Seat 6: anghelstefanesc ($3.82 in chips)
Seat 7: Pedrueza.06 ($0.73 in chips)
Seat 8: DrowsyDays ($4.35 in chips)
Seat 9: den1777den ($1.55 in chips)
den1777den: posts small blind $0.01
Zuludererste: posts big blind $0.02
*** HOLE CARDS ***
Dealt to pokerHero1 [Kh Js]
pokerHero1: folds
Undispute477: folds
stavochka008: folds
LegizBayk: folds
anghelstefanesc: folds
Pedrueza.06: folds
DrowsyDays: raises $0.04 to $0.06
den1777den: folds
Zuludererste: folds
Uncalled bet ($0.04) returned to DrowsyDays
DrowsyDays collected $0.05 from pot
DrowsyDays: doesn't show hand
*** SUMMARY ***
Total pot $0.05 | Rake $0
Seat 1: Zuludererste (big blind) folded before Flop
Seat 2: pokerHero1 folded before Flop (didn't bet)
Seat 3: Undispute477 folded before Flop (didn't bet)
Seat 4: stavochka008 folded before Flop (didn't bet)
Seat 5: LegizBayk folded before Flop (didn't bet)
Seat 6: anghelstefanesc folded before Flop (didn't bet)
Seat 7: Pedrueza.06 folded before Flop (didn't bet)
Seat 8: DrowsyDays (button) collected ($0.05)
Seat 9: den1777den (small blind) folded before Flop



PokerStars Hand #212513083565:  Hold'em No Limit ($0.01/$0.02 USD) - 2020/04/22 13:15:48 ET
Table 'Jena II' 9-max Seat #9 is the button
Seat 1: Zuludererste ($0.66 in chips)
Seat 2: pokerHero1 ($2.79 in chips)
Seat 3: Undispute477 ($1.81 in chips)
Seat 4: stavochka008 ($0.52 in chips)
Seat 5: LegizBayk ($0.65 in chips)
Seat 6: anghelstefanesc ($3.82 in chips)
Seat 7: Pedrueza.06 ($0.73 in chips)
Seat 8: DrowsyDays ($4.38 in chips)
Seat 9: den1777den ($1.54 in chips)
Zuludererste: posts small blind $0.01
pokerHero1: posts big blind $0.02
*** HOLE CARDS ***
Dealt to pokerHero1 [Td Kh]
Undispute477: folds
stavochka008: folds
LegizBayk: folds
anghelstefanesc: calls $0.02
Pedrueza.06 has timed out
Pedrueza.06: folds
DrowsyDays: folds
den1777den: calls $0.02
Zuludererste: calls $0.01
pokerHero1: checks
*** FLOP *** [6d 4d 2s]
Zuludererste: bets $0.10
pokerHero1: folds
anghelstefanesc: folds
den1777den: folds
Uncalled bet ($0.10) returned to Zuludererste
Zuludererste collected $0.08 from pot
Zuludererste: doesn't show hand
*** SUMMARY ***
Total pot $0.08 | Rake $0
Board [6d 4d 2s]
Seat 1: Zuludererste (small blind) collected ($0.08)
Seat 2: pokerHero1 (big blind) folded on the Flop
Seat 3: Undispute477 folded before Flop (didn't bet)
Seat 4: stavochka008 folded before Flop (didn't bet)
Seat 5: LegizBayk folded before Flop (didn't bet)
Seat 6: anghelstefanesc folded on the Flop
Seat 7: Pedrueza.06 folded before Flop (didn't bet)
Seat 8: DrowsyDays folded before Flop (didn't bet)
Seat 9: den1777den (button) folded on the Flop



PokerStars Hand #212513157216:  Hold'em No Limit ($0.01/$0.02 USD) - 2020/04/22 13:17:04 ET
Table 'Jena II' 9-max Seat #1 is the button
Seat 1: Zuludererste ($0.72 in chips)
Seat 2: pokerHero1 ($2.77 in chips)
Seat 3: Undispute477 ($1.81 in chips)
Seat 4: stavochka008 ($0.52 in chips)
Seat 5: LegizBayk ($0.65 in chips)
Seat 6: anghelstefanesc ($3.80 in chips)
Seat 7: Pedrueza.06 ($0.73 in chips)
Seat 8: DrowsyDays ($4.38 in chips)
Seat 9: den1777den ($1.52 in chips)
pokerHero1: posts small blind $0.01
Undispute477: posts big blind $0.02
*** HOLE CARDS ***
Dealt to pokerHero1 [Js Td]
stavochka008: calls $0.02
LegizBayk: calls $0.02
anghelstefanesc: calls $0.02
Pedrueza.06: folds
DrowsyDays: folds
den1777den: folds
Zuludererste: folds
pokerHero1: calls $0.01
Undispute477: raises $0.12 to $0.14
stavochka008: folds
LegizBayk: folds
anghelstefanesc: folds
pokerHero1: folds
Uncalled bet ($0.12) returned to Undispute477
Undispute477 collected $0.10 from pot
Undispute477: doesn't show hand
*** SUMMARY ***
Total pot $0.10 | Rake $0
Seat 1: Zuludererste (button) folded before Flop (didn't bet)
Seat 2: pokerHero1 (small blind) folded before Flop
Seat 3: Undispute477 (big blind) collected ($0.10)
Seat 4: stavochka008 folded before Flop
Seat 5: LegizBayk folded before Flop
Seat 6: anghelstefanesc folded before Flop
Seat 7: Pedrueza.06 folded before Flop (didn't bet)
Seat 8: DrowsyDays folded before Flop (didn't bet)
Seat 9: den1777den folded before Flop (didn't bet)



PokerStars Hand #212513226601:  Hold'em No Limit ($0.01/$0.02 USD) - 2020/04/22 13:18:08 ET
Table 'Jena II' 9-max Seat #2 is the button
Seat 1: Zuludererste ($0.72 in chips)
Seat 2: pokerHero1 ($2.75 in chips)
Seat 3: Undispute477 ($1.89 in chips)
Seat 4: stavochka008 ($0.50 in chips)
Seat 5: LegizBayk ($0.63 in chips)
Seat 6: anghelstefanesc ($3.78 in chips)
Seat 7: Pedrueza.06 ($0.73 in chips)
Seat 8: DrowsyDays ($4.38 in chips)
Seat 9: den1777den ($1.52 in chips)
Undispute477: posts small blind $0.01
stavochka008: posts big blind $0.02
*** HOLE CARDS ***
Dealt to pokerHero1 [3c 7d]
LegizBayk: calls $0.02
anghelstefanesc: folds
Pedrueza.06: calls $0.02
DrowsyDays: folds
den1777den: calls $0.02
Zuludererste: folds
pokerHero1: folds
Undispute477: folds
stavochka008: checks
*** FLOP *** [2h 4h 9h]
stavochka008: checks
LegizBayk: bets $0.02
Pedrueza.06: calls $0.02
den1777den: folds
stavochka008: calls $0.02
*** TURN *** [2h 4h 9h] [4s]
stavochka008: bets $0.02
LegizBayk: folds
Pedrueza.06: calls $0.02
*** RIVER *** [2h 4h 9h 4s] [Jc]
stavochka008: bets $0.06
Pedrueza.06: raises $0.61 to $0.67 and is all-in
stavochka008: folds
Uncalled bet ($0.61) returned to Pedrueza.06
Pedrueza.06 collected $0.30 from pot
Pedrueza.06: doesn't show hand
*** SUMMARY ***
Total pot $0.31 | Rake $0.01
Board [2h 4h 9h 4s Jc]
Seat 1: Zuludererste folded before Flop (didn't bet)
Seat 2: pokerHero1 (button) folded before Flop (didn't bet)
Seat 3: Undispute477 (small blind) folded before Flop
Seat 4: stavochka008 (big blind) folded on the River
Seat 5: LegizBayk folded on the Turn
Seat 6: anghelstefanesc folded before Flop (didn't bet)
Seat 7: Pedrueza.06 collected ($0.30)
Seat 8: DrowsyDays folded before Flop (didn't bet)
Seat 9: den1777den folded on the Flop



PokerStars Hand #212513328294:  Hold'em No Limit ($0.01/$0.02 USD) - 2020/04/22 13:19:52 ET
Table 'Jena II' 9-max Seat #3 is the button
Seat 1: Zuludererste ($0.72 in chips)
Seat 2: pokerHero1 ($2.75 in chips)
Seat 3: Undispute477 ($1.88 in chips)
Seat 4: stavochka008 ($0.38 in chips)
Seat 5: LegizBayk ($0.59 in chips)
Seat 6: anghelstefanesc ($3.78 in chips)
Seat 7: Pedrueza.06 ($0.91 in chips)
Seat 8: DrowsyDays ($4.38 in chips)
Seat 9: den1777den ($1.50 in chips)
stavochka008: posts small blind $0.01
LegizBayk: posts big blind $0.02
*** HOLE CARDS ***
Dealt to pokerHero1 [3d Td]
anghelstefanesc: calls $0.02
Pedrueza.06: folds
DrowsyDays: folds
den1777den: calls $0.02
Zuludererste: folds
pokerHero1: folds
Undispute477: folds
stavochka008: folds
LegizBayk: checks
*** FLOP *** [Kd 2s 5h]
LegizBayk: checks
anghelstefanesc: checks
den1777den: checks
*** TURN *** [Kd 2s 5h] [Ac]
LegizBayk: checks
anghelstefanesc: checks
den1777den: bets $0.04
LegizBayk: folds
anghelstefanesc: folds
Uncalled bet ($0.04) returned to den1777den
den1777den collected $0.07 from pot
*** SUMMARY ***
Total pot $0.07 | Rake $0
Board [Kd 2s 5h Ac]
Seat 1: Zuludererste folded before Flop (didn't bet)
Seat 2: pokerHero1 folded before Flop (didn't bet)
Seat 3: Undispute477 (button) folded before Flop (didn't bet)
Seat 4: stavochka008 (small blind) folded before Flop
Seat 5: LegizBayk (big blind) folded on the Turn
Seat 6: anghelstefanesc folded on the Turn
Seat 7: Pedrueza.06 folded before Flop (didn't bet)
Seat 8: DrowsyDays folded before Flop (didn't bet)
Seat 9: den1777den collected ($0.07)



PokerStars Hand #212513419105:  Hold'em No Limit ($0.01/$0.02 USD) - 2020/04/22 13:21:24 ET
Table 'Jena II' 9-max Seat #4 is the button
Seat 1: Zuludererste ($0.72 in chips)
Seat 2: pokerHero1 ($2.75 in chips)
Seat 3: Undispute477 ($1.88 in chips)
Seat 4: stavochka008 ($0.37 in chips)
Seat 5: LegizBayk ($0.57 in chips)
Seat 6: anghelstefanesc ($3.76 in chips)
Seat 7: Pedrueza.06 ($0.91 in chips)
Seat 8: DrowsyDays ($4.38 in chips)
Seat 9: den1777den ($1.55 in chips)
LegizBayk: posts small blind $0.01
Pedrueza.06 is disconnected
anghelstefanesc: posts big blind $0.02
*** HOLE CARDS ***
Dealt to pokerHero1 [5c Qd]
Pedrueza.06 has timed out while disconnected
Pedrueza.06: folds
DrowsyDays: raises $0.04 to $0.06
den1777den: folds
Zuludererste: folds
pokerHero1: folds
Undispute477: folds
stavochka008: folds
LegizBayk: calls $0.05
anghelstefanesc: calls $0.04
*** FLOP *** [8h 3h Jh]
LegizBayk: checks
anghelstefanesc: checks
DrowsyDays: bets $0.12
LegizBayk: folds
anghelstefanesc: calls $0.12
*** TURN *** [8h 3h Jh] [4s]
anghelstefanesc: checks
DrowsyDays: checks
*** RIVER *** [8h 3h Jh 4s] [7h]
anghelstefanesc: checks
DrowsyDays: bets $0.12
anghelstefanesc: calls $0.12
*** SHOW DOWN ***
DrowsyDays: shows [Qc Qh] (a flush, Queen high)
anghelstefanesc: mucks hand
DrowsyDays collected $0.64 from pot
*** SUMMARY ***
Total pot $0.66 | Rake $0.02
Board [8h 3h Jh 4s 7h]
Seat 1: Zuludererste folded before Flop (didn't bet)
Seat 2: pokerHero1 folded before Flop (didn't bet)
Seat 3: Undispute477 folded before Flop (didn't bet)
Seat 4: stavochka008 (button) folded before Flop (didn't bet)
Seat 5: LegizBayk (small blind) folded on the Flop
Seat 6: anghelstefanesc (big blind) mucked [Kd 9h]
Seat 7: Pedrueza.06 folded before Flop (didn't bet)
Seat 8: DrowsyDays showed [Qc Qh] and won ($0.64) with a flush, Queen high
Seat 9: den1777den folded before Flop (didn't bet)



PokerStars Hand #212513524378:  Hold'em No Limit ($0.01/$0.02 USD) - 2020/04/22 13:23:13 ET
Table 'Jena II' 9-max Seat #5 is the button
Seat 1: Zuludererste ($0.72 in chips)
Seat 2: pokerHero1 ($2.75 in chips)
Seat 3: Undispute477 ($1.88 in chips)
Seat 4: stavochka008 ($0.37 in chips)
Seat 5: LegizBayk ($0.51 in chips)
Seat 6: anghelstefanesc ($3.46 in chips)
Seat 7: Pedrueza.06 ($0.91 in chips)
Seat 8: DrowsyDays ($4.72 in chips)
Seat 9: den1777den ($1.55 in chips)
anghelstefanesc: posts small blind $0.01
Pedrueza.06: posts big blind $0.02
*** HOLE CARDS ***
Dealt to pokerHero1 [9d 4h]
DrowsyDays: folds
den1777den: folds
Zuludererste: folds
pokerHero1: folds
Undispute477: folds
stavochka008: calls $0.02
LegizBayk: folds
Zuludererste leaves the table
anghelstefanesc: calls $0.01
Pedrueza.06: checks
*** FLOP *** [Ts 7h Tc]
yjqian23 joins the table at seat #1
anghelstefanesc: checks
Pedrueza.06: checks
stavochka008: checks
*** TURN *** [Ts 7h Tc] [Kc]
anghelstefanesc: checks
Pedrueza.06: checks
stavochka008: bets $0.06
anghelstefanesc: calls $0.06
Pedrueza.06: folds
*** RIVER *** [Ts 7h Tc Kc] [Qc]
anghelstefanesc: checks
stavochka008: bets $0.12
anghelstefanesc: raises $0.18 to $0.30
stavochka008: folds
Uncalled bet ($0.18) returned to anghelstefanesc
anghelstefanesc collected $0.41 from pot
*** SUMMARY ***
Total pot $0.42 | Rake $0.01
Board [Ts 7h Tc Kc Qc]
Seat 1: Zuludererste folded before Flop (didn't bet)
Seat 2: pokerHero1 folded before Flop (didn't bet)
Seat 3: Undispute477 folded before Flop (didn't bet)
Seat 4: stavochka008 folded on the River
Seat 5: LegizBayk (button) folded before Flop (didn't bet)
Seat 6: anghelstefanesc (small blind) collected ($0.41)
Seat 7: Pedrueza.06 (big blind) folded on the Turn
Seat 8: DrowsyDays folded before Flop (didn't bet)
Seat 9: den1777den folded before Flop (didn't bet)



PokerStars Hand #212513604101:  Hold'em No Limit ($0.01/$0.02 USD) - 2020/04/22 13:24:36 ET
Table 'Jena II' 9-max Seat #6 is the button
Seat 2: pokerHero1 ($2.75 in chips)
Seat 3: Undispute477 ($1.88 in chips)
Seat 4: stavochka008 ($0.17 in chips)
Seat 5: LegizBayk ($0.51 in chips)
Seat 6: anghelstefanesc ($3.67 in chips)
Seat 7: Pedrueza.06 ($0.89 in chips)
Seat 8: DrowsyDays ($4.72 in chips)
Seat 9: den1777den ($1.55 in chips)
Pedrueza.06: posts small blind $0.01
DrowsyDays: posts big blind $0.02
yjqian23: sits out
*** HOLE CARDS ***
Dealt to pokerHero1 [Js 7c]
den1777den: folds
pokerHero1: folds
Undispute477: folds
stavochka008: calls $0.02
LegizBayk: folds
anghelstefanesc: calls $0.02
Pedrueza.06: calls $0.01
DrowsyDays: raises $0.06 to $0.08
stavochka008: calls $0.06
anghelstefanesc: calls $0.06
Pedrueza.06: calls $0.06
*** FLOP *** [5s 6c As]
Pedrueza.06: checks
DrowsyDays: bets $0.20
stavochka008: calls $0.09 and is all-in
anghelstefanesc: folds
Pedrueza.06: folds
Uncalled bet ($0.11) returned to DrowsyDays
*** TURN *** [5s 6c As] [9c]
*** RIVER *** [5s 6c As 9c] [Tc]
*** SHOW DOWN ***
DrowsyDays: shows [Ac Ah] (three of a kind, Aces)
stavochka008: shows [Kc 8s] (high card Ace)
DrowsyDays collected $0.48 from pot
*** SUMMARY ***
Total pot $0.50 | Rake $0.02
Board [5s 6c As 9c Tc]
Seat 2: pokerHero1 folded before Flop (didn't bet)
Seat 3: Undispute477 folded before Flop (didn't bet)
Seat 4: stavochka008 showed [Kc 8s] and lost with high card Ace
Seat 5: LegizBayk folded before Flop (didn't bet)
Seat 6: anghelstefanesc (button) folded on the Flop
Seat 7: Pedrueza.06 (small blind) folded on the Flop
Seat 8: DrowsyDays (big blind) showed [Ac Ah] and won ($0.48) with three of a kind, Aces
Seat 9: den1777den folded before Flop (didn't bet)



PokerStars Hand #212513704118:  Hold'em No Limit ($0.01/$0.02 USD) - 2020/04/22 13:26:16 ET
Table 'Jena II' 9-max Seat #7 is the button
Seat 2: pokerHero1 ($2.75 in chips)
Seat 3: Undispute477 ($1.88 in chips)
Seat 5: LegizBayk ($0.51 in chips)
Seat 6: anghelstefanesc ($3.59 in chips)
Seat 7: Pedrueza.06 ($0.81 in chips)
Seat 8: DrowsyDays ($5.03 in chips)
Seat 9: den1777den ($1.55 in chips)
DrowsyDays: posts small blind $0.01
den1777den: posts big blind $0.02
yjqian23: sits out
*** HOLE CARDS ***
Dealt to pokerHero1 [2c 8c]
pokerHero1: folds
stavochka008 leaves the table
Undispute477: folds
LegizBayk: calls $0.02
anghelstefanesc: folds
Pedrueza.06: calls $0.02
DrowsyDays: folds
den1777den: checks
*** FLOP *** [Tc Qc Ks]
den1777den: checks
LegizBayk: bets $0.02
Pedrueza.06: calls $0.02
den1777den: calls $0.02
*** TURN *** [Tc Qc Ks] [Jd]
den1777den: checks
LegizBayk: bets $0.04
h1_tech_1mba joins the table at seat #4
Pedrueza.06: calls $0.04
den1777den: calls $0.04
*** RIVER *** [Tc Qc Ks Jd] [Jh]
den1777den: checks
LegizBayk: checks
Pedrueza.06: bets $0.73 and is all-in
den1777den: folds
LegizBayk: folds
Uncalled bet ($0.73) returned to Pedrueza.06
Pedrueza.06 collected $0.24 from pot
Pedrueza.06: doesn't show hand
*** SUMMARY ***
Total pot $0.25 | Rake $0.01
Board [Tc Qc Ks Jd Jh]
Seat 2: pokerHero1 folded before Flop (didn't bet)
Seat 3: Undispute477 folded before Flop (didn't bet)
Seat 5: LegizBayk folded on the River
Seat 6: anghelstefanesc folded before Flop (didn't bet)
Seat 7: Pedrueza.06 (button) collected ($0.24)
Seat 8: DrowsyDays (small blind) folded before Flop
Seat 9: den1777den (big blind) folded on the River



PokerStars Hand #212513780661:  Hold'em No Limit ($0.01/$0.02 USD) - 2020/04/22 13:27:34 ET
Table 'Jena II' 9-max Seat #8 is the button
Seat 1: yjqian23 ($2 in chips)
Seat 2: pokerHero1 ($2.75 in chips)
Seat 3: Undispute477 ($1.88 in chips)
Seat 5: LegizBayk ($0.43 in chips)
Seat 6: anghelstefanesc ($3.59 in chips)
Seat 7: Pedrueza.06 ($0.97 in chips)
Seat 8: DrowsyDays ($5.02 in chips)
Seat 9: den1777den ($1.47 in chips)
den1777den: posts small blind $0.01
yjqian23: posts big blind $0.02
h1_tech_1mba: sits out
*** HOLE CARDS ***
Dealt to pokerHero1 [Ah 9c]
pokerHero1: folds
Undispute477: folds
LegizBayk: calls $0.02
anghelstefanesc: folds
Pedrueza.06: folds
DrowsyDays: folds
den1777den: calls $0.01
yjqian23: raises $0.28 to $0.30
LegizBayk: folds
den1777den: folds
Uncalled bet ($0.28) returned to yjqian23
yjqian23 collected $0.06 from pot
yjqian23: doesn't show hand
*** SUMMARY ***
Total pot $0.06 | Rake $0
Seat 1: yjqian23 (big blind) collected ($0.06)
Seat 2: pokerHero1 folded before Flop (didn't bet)
Seat 3: Undispute477 folded before Flop (didn't bet)
Seat 5: LegizBayk folded before Flop
Seat 6: anghelstefanesc folded before Flop (didn't bet)
Seat 7: Pedrueza.06 folded before Flop (didn't bet)
Seat 8: DrowsyDays (button) folded before Flop (didn't bet)
Seat 9: den1777den (small blind) folded before Flop



PokerStars Hand #212513820533:  Hold'em No Limit ($0.01/$0.02 USD) - 2020/04/22 13:28:15 ET
Table 'Jena II' 9-max Seat #9 is the button
Seat 1: yjqian23 ($2.04 in chips)
Seat 2: pokerHero1 ($2.75 in chips)
Seat 3: Undispute477 ($1.88 in chips)
Seat 5: LegizBayk ($0.41 in chips)
Seat 6: anghelstefanesc ($3.59 in chips)
Seat 7: Pedrueza.06 ($0.97 in chips)
Seat 8: DrowsyDays ($5.02 in chips)
Seat 9: den1777den ($1.45 in chips)
yjqian23: posts small blind $0.01
pokerHero1: posts big blind $0.02
h1_tech_1mba: sits out
*** HOLE CARDS ***
Dealt to pokerHero1 [Js Jd]
Undispute477: folds
LegizBayk: calls $0.02
anghelstefanesc: folds
Pedrueza.06: folds
DrowsyDays: folds
den1777den: calls $0.02
yjqian23: folds
pokerHero1: raises $0.08 to $0.10
LegizBayk: folds
den1777den: calls $0.08
*** FLOP *** [3c Kd 9d]
pokerHero1: bets $0.18
den1777den: calls $0.18
*** TURN *** [3c Kd 9d] [2c]
pokerHero1: checks
den1777den: bets $0.29
pokerHero1: folds
Uncalled bet ($0.29) returned to den1777den
den1777den collected $0.57 from pot
*** SUMMARY ***
Total pot $0.59 | Rake $0.02
Board [3c Kd 9d 2c]
Seat 1: yjqian23 (small blind) folded before Flop
Seat 2: pokerHero1 (big blind) folded on the Turn
Seat 3: Undispute477 folded before Flop (didn't bet)
Seat 5: LegizBayk folded before Flop
Seat 6: anghelstefanesc folded before Flop (didn't bet)
Seat 7: Pedrueza.06 folded before Flop (didn't bet)
Seat 8: DrowsyDays folded before Flop (didn't bet)
Seat 9: den1777den (button) collected ($0.57)



PokerStars Hand #212513887016:  Hold'em No Limit ($0.01/$0.02 USD) - 2020/04/22 13:29:24 ET
Table 'Jena II' 9-max Seat #1 is the button
Seat 1: yjqian23 ($2.03 in chips)
Seat 2: pokerHero1 ($2.47 in chips)
Seat 3: Undispute477 ($1.88 in chips)
Seat 5: LegizBayk ($0.39 in chips)
Seat 6: anghelstefanesc ($3.59 in chips)
Seat 7: Pedrueza.06 ($0.97 in chips)
Seat 8: DrowsyDays ($5.02 in chips)
Seat 9: den1777den ($1.74 in chips)
pokerHero1: posts small blind $0.01
Undispute477: posts big blind $0.02
h1_tech_1mba: sits out
*** HOLE CARDS ***
Dealt to pokerHero1 [3h 9h]
LegizBayk: calls $0.02
anghelstefanesc: calls $0.02
Pedrueza.06: folds
DrowsyDays: folds
den1777den: folds
yjqian23: folds
yjqian23 leaves the table
pokerHero1: calls $0.01
Undispute477: checks
*** FLOP *** [9d 4s Ah]
Kazanchik777 joins the table at seat #1
pokerHero1: checks
Undispute477: checks
LegizBayk: bets $0.02
anghelstefanesc: folds
pokerHero1: folds
Undispute477: folds
Uncalled bet ($0.02) returned to LegizBayk
LegizBayk collected $0.08 from pot
LegizBayk: doesn't show hand
*** SUMMARY ***
Total pot $0.08 | Rake $0
Board [9d 4s Ah]
Seat 1: yjqian23 (button) folded before Flop (didn't bet)
Seat 2: pokerHero1 (small blind) folded on the Flop
Seat 3: Undispute477 (big blind) folded on the Flop
Seat 5: LegizBayk collected ($0.08)
Seat 6: anghelstefanesc folded on the Flop
Seat 7: Pedrueza.06 folded before Flop (didn't bet)
Seat 8: DrowsyDays folded before Flop (didn't bet)
Seat 9: den1777den folded before Flop (didn't bet)



PokerStars Hand #212513950260:  Hold'em No Limit ($0.01/$0.02 USD) - 2020/04/22 13:30:29 ET
Table 'Jena II' 9-max Seat #2 is the button
Seat 2: pokerHero1 ($2.45 in chips)
Seat 3: Undispute477 ($1.86 in chips)
Seat 4: h1_tech_1mba ($2 in chips)
Seat 5: LegizBayk ($0.45 in chips)
Seat 6: anghelstefanesc ($3.57 in chips)
Seat 7: Pedrueza.06 ($0.97 in chips)
Seat 8: DrowsyDays ($5.02 in chips)
Seat 9: den1777den ($1.74 in chips)
Undispute477: posts small blind $0.01
h1_tech_1mba: posts big blind $0.02
Kazanchik777: sits out
*** HOLE CARDS ***
Dealt to pokerHero1 [Qc 8h]
LegizBayk: folds
anghelstefanesc: folds
Pedrueza.06: calls $0.02
DrowsyDays: folds
den1777den: folds
pokerHero1: folds
Undispute477: folds
h1_tech_1mba: checks
*** FLOP *** [Jh 2h 7c]
h1_tech_1mba: checks
Pedrueza.06: checks
*** TURN *** [Jh 2h 7c] [4s]
h1_tech_1mba: checks
Pedrueza.06: checks
*** RIVER *** [Jh 2h 7c 4s] [4d]
h1_tech_1mba: checks
Pedrueza.06: checks
*** SHOW DOWN ***
h1_tech_1mba: shows [Ts 6h] (a pair of Fours)
Pedrueza.06: shows [Kc 8s] (a pair of Fours - King kicker)
Pedrueza.06 collected $0.05 from pot
*** SUMMARY ***
Total pot $0.05 | Rake $0
Board [Jh 2h 7c 4s 4d]
Seat 2: pokerHero1 (button) folded before Flop (didn't bet)
Seat 3: Undispute477 (small blind) folded before Flop
Seat 4: h1_tech_1mba (big blind) showed [Ts 6h] and lost with a pair of Fours
Seat 5: LegizBayk folded before Flop (didn't bet)
Seat 6: anghelstefanesc folded before Flop (didn't bet)
Seat 7: Pedrueza.06 showed [Kc 8s] and won ($0.05) with a pair of Fours
Seat 8: DrowsyDays folded before Flop (didn't bet)
Seat 9: den1777den folded before Flop (didn't bet)



PokerStars Hand #212514006580:  Hold'em No Limit ($0.01/$0.02 USD) - 2020/04/22 13:31:26 ET
Table 'Jena II' 9-max Seat #3 is the button
Seat 2: pokerHero1 ($2.45 in chips)
Seat 3: Undispute477 ($1.85 in chips)
Seat 4: h1_tech_1mba ($2 in chips)
Seat 5: LegizBayk ($0.45 in chips)
Seat 6: anghelstefanesc ($3.57 in chips)
Seat 7: Pedrueza.06 ($1 in chips)
Seat 8: DrowsyDays ($5.02 in chips)
Seat 9: den1777den ($1.74 in chips)
h1_tech_1mba: posts small blind $0.01
LegizBayk: posts big blind $0.02
Kazanchik777: sits out
*** HOLE CARDS ***
Dealt to pokerHero1 [6s 8s]
anghelstefanesc: raises $0.02 to $0.04
Pedrueza.06: folds
DrowsyDays: folds
den1777den: folds
pokerHero1: folds
Undispute477: folds
h1_tech_1mba: folds
LegizBayk: raises $0.02 to $0.06
anghelstefanesc: calls $0.02
*** FLOP *** [8c 7s Kc]
LegizBayk: bets $0.06
anghelstefanesc: raises $0.25 to $0.31
LegizBayk: folds
Uncalled bet ($0.25) returned to anghelstefanesc
anghelstefanesc collected $0.24 from pot
*** SUMMARY ***
Total pot $0.25 | Rake $0.01
Board [8c 7s Kc]
Seat 2: pokerHero1 folded before Flop (didn't bet)
Seat 3: Undispute477 (button) folded before Flop (didn't bet)
Seat 4: h1_tech_1mba (small blind) folded before Flop
Seat 5: LegizBayk (big blind) folded on the Flop
Seat 6: anghelstefanesc collected ($0.24)
Seat 7: Pedrueza.06 folded before Flop (didn't bet)
Seat 8: DrowsyDays folded before Flop (didn't bet)
Seat 9: den1777den folded before Flop (didn't bet)



PokerStars Hand #212514068811:  Hold'em No Limit ($0.01/$0.02 USD) - 2020/04/22 13:32:30 ET
Table 'Jena II' 9-max Seat #4 is the button
Seat 2: pokerHero1 ($2.45 in chips)
Seat 3: Undispute477 ($1.85 in chips)
Seat 4: h1_tech_1mba ($2 in chips)
Seat 5: LegizBayk ($0.33 in chips)
Seat 6: anghelstefanesc ($3.69 in chips)
Seat 7: Pedrueza.06 ($1 in chips)
Seat 8: DrowsyDays ($5.02 in chips)
Seat 9: den1777den ($1.74 in chips)
LegizBayk: posts small blind $0.01
anghelstefanesc: posts big blind $0.02
Kazanchik777: sits out
*** HOLE CARDS ***
Dealt to pokerHero1 [2h Qc]
Pedrueza.06: folds
DrowsyDays: folds
den1777den: folds
pokerHero1: folds
Undispute477: folds
h1_tech_1mba: folds
LegizBayk: calls $0.01
anghelstefanesc: checks
*** FLOP *** [6c 6d 5h]
LegizBayk: checks
anghelstefanesc: checks
*** TURN *** [6c 6d 5h] [2c]
LegizBayk: checks
anghelstefanesc: checks
*** RIVER *** [6c 6d 5h 2c] [9d]
LegizBayk: checks
anghelstefanesc: checks
*** SHOW DOWN ***
LegizBayk: shows [Ts Jc] (a pair of Sixes)
anghelstefanesc: shows [Qs 4h] (a pair of Sixes - Queen kicker)
anghelstefanesc collected $0.04 from pot
*** SUMMARY ***
Total pot $0.04 | Rake $0
Board [6c 6d 5h 2c 9d]
Seat 2: pokerHero1 folded before Flop (didn't bet)
Seat 3: Undispute477 folded before Flop (didn't bet)
Seat 4: h1_tech_1mba (button) folded before Flop (didn't bet)
Seat 5: LegizBayk (small blind) showed [Ts Jc] and lost with a pair of Sixes
Seat 6: anghelstefanesc (big blind) showed [Qs 4h] and won ($0.04) with a pair of Sixes
Seat 7: Pedrueza.06 folded before Flop (didn't bet)
Seat 8: DrowsyDays folded before Flop (didn't bet)
Seat 9: den1777den folded before Flop (didn't bet)



PokerStars Hand #212514128537:  Hold'em No Limit ($0.01/$0.02 USD) - 2020/04/22 13:33:30 ET
Table 'Jena II' 9-max Seat #5 is the button
Seat 2: pokerHero1 ($2.45 in chips)
Seat 3: Undispute477 ($1.85 in chips)
Seat 4: h1_tech_1mba ($2 in chips)
Seat 5: LegizBayk ($0.31 in chips)
Seat 6: anghelstefanesc ($3.71 in chips)
Seat 7: Pedrueza.06 ($1 in chips)
Seat 8: DrowsyDays ($5.02 in chips)
Seat 9: den1777den ($1.74 in chips)
anghelstefanesc: posts small blind $0.01
Pedrueza.06: posts big blind $0.02
Kazanchik777: sits out
*** HOLE CARDS ***
Dealt to pokerHero1 [3d Qc]
DrowsyDays: folds
den1777den: folds
pokerHero1: folds
Undispute477 has timed out
Undispute477: folds
h1_tech_1mba: folds
LegizBayk: folds
anghelstefanesc: calls $0.01
Pedrueza.06: checks
*** FLOP *** [6h 2c Jd]
anghelstefanesc: checks
Pedrueza.06: checks
*** TURN *** [6h 2c Jd] [3s]
anghelstefanesc: checks
Pedrueza.06: checks
*** RIVER *** [6h 2c Jd 3s] [Kd]
anghelstefanesc: bets $0.02
Pedrueza.06: calls $0.02
*** SHOW DOWN ***
anghelstefanesc: shows [Kh 8s] (a pair of Kings)
Pedrueza.06: mucks hand
anghelstefanesc collected $0.08 from pot
*** SUMMARY ***
Total pot $0.08 | Rake $0
Board [6h 2c Jd 3s Kd]
Seat 2: pokerHero1 folded before Flop (didn't bet)
Seat 3: Undispute477 folded before Flop (didn't bet)
Seat 4: h1_tech_1mba folded before Flop (didn't bet)
Seat 5: LegizBayk (button) folded before Flop (didn't bet)
Seat 6: anghelstefanesc (small blind) showed [Kh 8s] and won ($0.08) with a pair of Kings
Seat 7: Pedrueza.06 (big blind) mucked [Ts Js]
Seat 8: DrowsyDays folded before Flop (didn't bet)
Seat 9: den1777den folded before Flop (didn't bet)



PokerStars Hand #212514211523:  Hold'em No Limit ($0.01/$0.02 USD) - 2020/04/22 13:34:55 ET
Table 'Jena II' 9-max Seat #6 is the button
Seat 2: pokerHero1 ($2.45 in chips)
Seat 3: Undispute477 ($1.85 in chips)
Seat 4: h1_tech_1mba ($2 in chips)
Seat 5: LegizBayk ($0.31 in chips)
Seat 6: anghelstefanesc ($3.75 in chips)
Seat 7: Pedrueza.06 ($0.96 in chips)
Seat 8: DrowsyDays ($5.02 in chips)
Seat 9: den1777den ($1.74 in chips)
Pedrueza.06: posts small blind $0.01
DrowsyDays: posts big blind $0.02
Kazanchik777: sits out
*** HOLE CARDS ***
Dealt to pokerHero1 [2d Jd]
den1777den: calls $0.02
pokerHero1: folds
Undispute477: folds
h1_tech_1mba: folds
LegizBayk: calls $0.02
anghelstefanesc: calls $0.02
Pedrueza.06: calls $0.01
DrowsyDays: checks
*** FLOP *** [9d 6s Js]
Pedrueza.06: checks
DrowsyDays: checks
den1777den: bets $0.05
LegizBayk: calls $0.05
anghelstefanesc: calls $0.05
Pedrueza.06: folds
DrowsyDays: folds
*** TURN *** [9d 6s Js] [Jh]
den1777den: bets $0.12
LegizBayk: calls $0.12
anghelstefanesc: calls $0.12
*** RIVER *** [9d 6s Js Jh] [3s]
den1777den: bets $0.30
LegizBayk: calls $0.12 and is all-in
anghelstefanesc: folds
Uncalled bet ($0.18) returned to den1777den
*** SHOW DOWN ***
den1777den: shows [As Ks] (a flush, Ace high)
LegizBayk: shows [9s Jc] (a full house, Jacks full of Nines)
LegizBayk collected $0.82 from pot
*** SUMMARY ***
Total pot $0.85 | Rake $0.03
Board [9d 6s Js Jh 3s]
Seat 2: pokerHero1 folded before Flop (didn't bet)
Seat 3: Undispute477 folded before Flop (didn't bet)
Seat 4: h1_tech_1mba folded before Flop (didn't bet)
Seat 5: LegizBayk showed [9s Jc] and won ($0.82) with a full house, Jacks full of Nines
Seat 6: anghelstefanesc (button) folded on the River
Seat 7: Pedrueza.06 (small blind) folded on the Flop
Seat 8: DrowsyDays (big blind) folded on the Flop
Seat 9: den1777den showed [As Ks] and lost with a flush, Ace high



PokerStars Hand #212514333817:  Hold'em No Limit ($0.01/$0.02 USD) - 2020/04/22 13:36:58 ET
Table 'Jena II' 9-max Seat #7 is the button
Seat 2: pokerHero1 ($2.45 in chips)
Seat 3: Undispute477 ($1.85 in chips)
Seat 4: h1_tech_1mba ($2 in chips)
Seat 5: LegizBayk ($0.82 in chips)
Seat 6: anghelstefanesc ($3.56 in chips)
Seat 7: Pedrueza.06 ($0.94 in chips)
Seat 8: DrowsyDays ($5 in chips)
Seat 9: den1777den ($1.43 in chips)
DrowsyDays: posts small blind $0.01
den1777den: posts big blind $0.02
Kazanchik777: sits out
*** HOLE CARDS ***
Dealt to pokerHero1 [7s Jd]
pokerHero1: folds
Undispute477: folds
h1_tech_1mba: folds
LegizBayk: calls $0.02
anghelstefanesc: raises $0.07 to $0.09
Pedrueza.06: folds
DrowsyDays: folds
den1777den: folds
LegizBayk: folds
Uncalled bet ($0.07) returned to anghelstefanesc
anghelstefanesc collected $0.07 from pot
anghelstefanesc: doesn't show hand
*** SUMMARY ***
Total pot $0.07 | Rake $0
Seat 2: pokerHero1 folded before Flop (didn't bet)
Seat 3: Undispute477 folded before Flop (didn't bet)
Seat 4: h1_tech_1mba folded before Flop (didn't bet)
Seat 5: LegizBayk folded before Flop
Seat 6: anghelstefanesc collected ($0.07)
Seat 7: Pedrueza.06 (button) folded before Flop (didn't bet)
Seat 8: DrowsyDays (small blind) folded before Flop
Seat 9: den1777den (big blind) folded before Flop



